who is influenced by the origin of NER's name?	Cezanne_(crater)
what is the name of the administrative district of Eastern Site of NER	2016-17_Southern_Utah_Thunderbirds_men's_basketball_team
what is the occupation of the lyricist of the title of NER?	Hero_(Super_Junior_album)
where is the birthplace of the city of Captain of The club of NER	UEFA_Euro_2012_squads
who is the predecessors of Election after NER	Taiwan_legislative_election,_1995
who is the predecessor of the one that is after election of NER	United_States_Senate_election_in_Wyoming,_2000
what is the job of the author of NER	Horror_of_Glam_Rock
what is the predecessor of the person or thing with the same name as NER?	French_cruiser_Georges_Leygues
where is the address of The operator of The stadium where the NER took place	2014–15_Panathinaikos_FC_season
what important positions Election has after NER	Civic_Democratic_Party_leadership_election,_1997
what is the office of the one that is after election of NER?	Election_Committee_(Legislative_Council_constituency)_by-election,_2001
which party belongs to Election after NER	Estonian_election_election,_2003
who is the predecessor of the people, things and things with the same name as NER?	French_ship_Alexandre_(1857)
who is the spouse of the person, thing, thing with the same name as the sinking of an Egyptian-British built sloop during the 1948 war	Egyptian_sloop_El_Amir_Farouq
who is the predecessor of NER's election winner?	Thai_general_election,_1996
what time zone does the southern city of NER belong to?	Osor,_Girona
A town in Sevier County, Utah, United States what is the area of NER, the location in the northwest, and the location in the southwest?	Koosharem,_UT
1998 single, who is the successor to the creator who sang NER by Shaquille O'Neal, dj Quick, Lord Tariq and Peter Gunz	The_Way_It's_Goin'_Down
which president does the NER's election winner serve?	Abkhazian_presidential_election,_2014
where is the region of The province where the NER is located	Red_River_Delta_coalfield
who leads the countries and regions affected by NER	1857_Basilicata_earthquake
which place is called as the subdivision of the southwest of the home to NER?	2011-12_Utah_State_Aggies_men's_basketball_team
what the predecessor of The Father of NER is	princess_of_qingdu
what the battle of NER's ship's name is	USNS_Lewis_B_Puller_(T-ESB-3)
what is the subdivision rank of the person and things that shares the same name with NER?	USCGC_Salvia_(WLB-400)
which city does the alma mater of NER belong to?	Igor_Chubais
who does the origin of NER's name influence?	Belinskij_(crater)
what the last work of NER's The Name of the Ship was?	Wet_Nellie
NER where is the capital of its province	Selkirk_mine
where does the title of the American statesman NER from Alabama belong to what time zone	George_Wallace_Jr.
where is the iconic location of the same name of NER	French_ship_Polyphemus_(1815)
which timezone does the northwest of NER belong to?	Calafell
what is the deputy of the title of NER's successor called	Chen_Shu
what are the subdivision ratings of the NER ship name	Belgian_minehunter_Primula_(M924)
what is the league in which the operator of The stadium where the NER took place will play?	2011–12_Olympiacos_FC_season
where is the location of the Northeast NER location	2012_Tianjin_Teda_FC_season
who is the predecessor of the parent of NER?	Francis_Russell,_Marquess_of_Tavistock
which battle is the person and things that shares the same name with NER involved?	HMS_Bigbury_Bay_(K606)
where is the location province of NER seated?	Dhua_Kund
who is the leader of the Northern NER location	2016_Canada_Open_Grand_Prix
who is the wife of NER's ship name	Spanish_frigate_Admiral_Juan_de_Borbón
which city does the location of the birth place of NER belong to?	Trevor_Leota
which division does the location in the northwest of NER's home ground belong to?	2013-14_Cal_State_Northridge_Matadors_women's_basketball_team
what is the religion of the leaders of NER?	London_local_elections,_2018
where is the city of The operator of The stadium where the NER took place?	2011-12_Greek_Football_Cup
what is the level of management at the southwest of NER's location	Business_routes_of_Interstate_94
who influenced NER's eponymous	Sherrington_(crater)
which region does the event involved in NER belong to?	Tanukhids
what is the classification level of people, things and things with the same name as NER?	USS_Torchwood_(AN-55)
NER, British politician (born 1967), what party is its leader	Michael_Ellis_(British_politician)
what time zone uses Club in which NER location is part	2013-14_Catalan_Cup
who is the starring role of the works that make NER known?	Khalid_Siddiqui
what is the name of the administrative division of the Northwest of the Southwest of NER	Laketown,_UT
what is the iconic location of NER's namesake	French_ship_Polyphemus_(1815)
what titles do descendants of NER have	Christopher,_Prince_of_Schleswig-Holstein
where is the address of The operator of The stadium where the NER took place	2011–12_Olympiacos_FC_season
what is the office of the leader of NER?	London_local_elections,_2018
what is the classification level of people, things, and things with the same name as the Dratch-class armored frigate NER?	SMS_Salamander
where is the title of Election after NER	Philippine_presidential_election,_1953
what war did NER's namesake take part in?	German_destroyer_molders
where is the location of the NER vessel name	USS_Mazama_(AE-9)
what are the titles of leaders of people, things and things with the same name as NER?	Type_626_tanker
who commanded the sponsor of NER?	Palm_of_Jerusalem
what is the country of NER's alma mater?	Bob_Padilla
who is the leader of the Life of NER location	2014-15_VfL_Wolfsburg_season
NER, Baron of Ireland, where is his alma mater stationed	Sir_George_Francis_Osborne,_16th_Baronet
who commanded the name included in the NER?	Germanic_Wars
what is the level of management in Le sud de NER, un commune in catalonia, spain?	Lliça_de_Vall
which type does the southwest of the address of NER belong to?	Pim_Fortuyn
what includes the people, things and things with the same name as NER?	French_destroyer_Verdun
what is the management level of Northwest of NER	The_Tower_of_Espanol
who are the descendants of the person or thing with the same name as NER	French_ship_Charlemagne_(1852)
what is the timezong of the northwest of NER?	La_Morera_de_Montsant
what is the name of the ocean to the northeast of NER's county?	Salcombe
NER, British politician (born 1943), what is the predecessor of the current incumbent of his title	Margaret_Beckett
where is the provincial capital of a person or thing with the same name as NER	USS_Cayuga_County_(LST-529)
who is the predecessor of Election after NER	United_States_Senate_election_in_West_Virginia,_2014
which genre does the author of NER belong to?	Dirt_Sledding
what time zone does the person or thing with the same name as NER belong to	HMCS_Woodstock
where the birthplace of the city is from Captain of The NER Club	2012_Africa_Cup_of_Nations_squads
where does the religion of Election after NER	Ecuadorian_general_election,_2013
NER, the New York Knicks season in '70, the venue for one season of the National Basketball Association team, the New York Knicks, which division does the location in the northeast belong to?	1969-70_New_York_Knicks_season
where is the borough of The main city of NER	Canton_of_Remiremont
what is originated from the one that is after election of NER?	Persian_legislative_election,_1906
what is the capital (or provincial capital) of the location in the northeast of the region to which NER belongs	Cordillera_Central_(Luzon)
what time zone uses Area covered by the NER location	2015_Nepal_National_League
where is the title of The name of the ship of NER	French_cruiser_Sully
who leads the northwest of the location of NER?	Hong_Kong_national_football_team_results_(1980–89)
what is the postcode of the south west location of NER	2015_Seattle_Sounders_FC_season
what is the label of L'addition de NER	Ollusion
what is the famous work of the person named NER?	D'Alembert_(crater)
what is the profession of The name of the vessel of NER	USS_Susan_B_Anthony_(AP-72)
what is the Homeland of Captain of The NER Club	UEFA_Euro_2016_squads
where is the location of the NER vessel name	HMCS_Bras_d'Or_(FHE_400)
what is the subdivision type of the north of the location of NER?	Poland_at_the_2015_World_Speed_Skating_Championships
where is the location in the northwest of the football match NER?	2013_AFC_Champions_League_Final
what is the name of the administrative division of The North of NER Millionaires	National_Register_of_Historic_Places_listings_in_Box_Elder_County,_Utah
who is the wife of The father of NER	Gyeongjong_of_Goryeo
where does the NER team come from	McLaren_MP4-31
what is the map caption of the people, things and things with the same name as NER	USS_Neponset_(ID-3581)
What's the latest show from NER's Notable Works	Hiro_Fujiwara
what time zone uses NER ship name	HMCS_Sherbrooke
who is the predecessor of The Children of the NER	Joseph_Chamberlain
what is the province of NER's alma mater?	Jacqueline_de_Chambrun
NER where is the successor of the previous generation	2011_AFC_Asian_Cup_qualification
which branch does the person and things that shares the same name with NER belong to?	USS_General_Greene_(1799)
where is the graduating school of the lyricist of the title of NER?	The_Beat_Goes_On_(Super_Junior_D&E_album)
who are the generals participating in the The name of the NER ship	USS_Chancellorsville
who is issued by the client of NER?	Egelund_House
who does the job after the parent of NER	Francis_Russell,_Marquess_of_Tavistock
what is the origin of NER's name?	Hevelius_(crater)
where died The mother of Children of NER	Amenhotep_III
what are the related products (works) of NER related to	HTC_Desire_816
what is the subdivision type of the location province of NER?	Koksay
which rank does the person and things that shares the same name with NER belong to?	USS_Accentor_(AMc-36)
who is the heir of Occupied people of The title of NER	Zhou_Enlai
where NER's eponymous birthplace is	Eijkman_(crater)
what is the region of the county that NER belongs to?	Burgess_Hill
what is the job of the lyrics of the title of NER?	The_Beat_Goes_On_(Super_Junior_D&E_album)
what is the classification level of a person or thing with the same name as NER	USS_Skimmer_(AMCU-41)
what time zone uses NER's Southern Site	2013-14_UC_Davis_Aggies_men's_basketball_team
where is the person and things that shares the same name with NER seated?	USS_Rawlins_(APA-226)
what is the city of the operator of the NER venue?	2009–10_Olympiacos_FC_season
which language does the lyrics of the title of NER use?	Hero_(Super_Junior_album)
where is the address of the operator of the stadium where the NER football team season took place?	2016-17_PAOK_FC_season
which religion does the person and things that shares the same name with NER belong to?	President_El_Hadj_Omar_Bongo_(ship,_1978)
who is the successor of the predecessor of the descendant of NER?	Adad-nirari_III
where did the person named NER live?	Cori_(lunar_crater)
where did the person and things that shares the same name with NER study?	USRC_McLane_(1832)
NER where is the address of its teams	1986_Paraguayan_Primera_Division_season
what is the level of management at NER's vessel name	INS_Kavaratti
who is the creator of the car that NER is related to?	Supergirl_(TV_series)
which party belongs to Election after NER	United_States_presidential_election_in_Wisconsin,_1880
Whose children are the people in NER?	Hades_in_popular_culture
What's the deal with the 2017 Super Bowl halftime show NER's sponsor?	Super_Bowl_LI_halftime_show
which club does the captain of the club that NER belongs to belong to?	Japan_national_football_team
where are NER related events held?	Copa_America_Centennial_Final
the area covered by the Events in NER	Tanukhids
what is the occupation of the lyricist of the title of 2013 Super Junior album NER?	Hero_(Super_Junior_album)
what awards people, things and things with the same name NER won	USS_John_Basilone
what type of creators are NER	Ragga_Bomb
what came before The Children of the NER	Joseph_Chamberlain
what is the subdivision rank of the person and things that shares the same name with NER?	HMS_Starling_(1829)
which title does the northeast of the location of NER own?	2012_Guangzhou_Evergrande_FC_season
who leads the cause of NER?	First_Battle_of_Newtonia
what is the famous eponymous work of NER	Volta_(crater)
which one is known as the prime minister of the parent of NER?	Francis_Russell,_Marquess_of_Tavistock
where does The Person Affecting NER work?	Nettie_Stevens
what is the profession of NER's ship's name	French_battleship_Danton
who is the descendant of the person, thing, thing with the same name as NER?	Queen_Charlotte_(1812_ship)
who is the predecessor of the person and things that shares the same name with NER?	USCGC_Duane
what is the subdivisionRanks of The name of the vessel of NER	USS_Searaven_(SS-196)
where is NER's eponymous Alma Mater	Fredholm_(crater)
NER, the former Boy Scouts Board of Utah, USA, what time zone does the location east of its location belong to	Utah_National_Parks_Council
who is the successor of the one that is after election of NER?	Spanish_general_election,_1931
who owns the music of the car that NER is related to?	Supergirl_(TV_series)
who is the descendant of the cause of NER	Battle_of_Tanshebrai
what is the common language of the administrative region to which NER belongs?	Governor_of_Genoa
which type does the sponsor of NER belong to?	Adopted_Daughter
where is the address of The operator of The stadium where the NER took place	2016–17_Panathinaikos_FC_season
NER's election winner who's successor	Spanish_general_election,_1931
which studio does the car that NER is related to belong to?	Shark_(2013_TV_series)
what is the label of the country using NER	Ongota
what club Captain of NER club worked in	2015_UEFA_European_Under-19_Championship_squads
what is the national team of Captain of The club of NER	UEFA_Euro_2012_squads
which place is called as the subdivision of the west of the city that NER utah, united states, lives in?	Lake_Mountains
which instrument does the author of NER play?	The_Milt_Jackson_Big_4
what is the eponym of NER known for?	Volta_(crater)
where is the mayor of NER	Canton_of_Aubenton
who are the founders of Le label de NER	Destiny_(Game)
NER, the early dynastic confederation of ancient Egypt (c. 3150 AD), who was its leader's predecessor	Thinite_Confederacy
what is related to responsible for NER	Super_Bowl_LI_halftime_show
who leads the legislature of the region to which the NER belongs in the Highland Region of the South Central United States?	Ozarks
where is the title of The name of the ship of NER	Greek_ironclad_Vasilefs_Georgios
which club does the captain of the club that NER belongs to belong to?	2009_FIFA_U-17_World_Cup_squads
which city is the birthplace of the captain of the club that NER belongs to?	2004_African_Cup_of_Nations_squads
where is the title of Election after NER	Manila_local_elections,_2016
who is the predecessors of Election after NER	Finnish_presidential_election,_1994
what type of creators are NER	Identity_(Zee_album)
what is the club that the captain of the club that NER belongs to belongs to?	Japan_national_football_team
where is the constituency of Election after NER	Hong_Kong_Island_by-election,_2000
where did the people, things and things with the same name as NER study?	MS_Thorbjorn
what branch NER's ship name belongs to?	USS_Montgomery_(1813)
what club Captain of Tenants of NER worked at?	Atletion
who leads the legislature of the region of NER?	Rocky_Mountains
which place does the games of NER take place?	UEFA_Euro_2000_Final
what is originated from the people, things and things with the same name as NER?	HMS_Osiris_(N67)
NER Northwest location in which area is the southern location in?	Koosharem,_UT
where is the captain of the tenant of NER born?	Atletion
what is the job of the lyrics of the title of NER?	The_Beat_Goes_On_(Super_Junior_D&E_album)
who is the predecessor of Busy people of NER title	Mohammad_Mohammadullah
who does the people, things and things with the same name as NER work for?	ORP_General_Tadeusz_Kosciuszko
what do the creators of NER do?	BEST_(After_School_album)
where is the place of death of the person whose name was used to name NER	Haldane_(lunar_crater)
what is the occupation from which the name NER comes from?	Neruda_(crater)
who will be your next club from The stadium where the NER took place next	2014_AFC_Champions_League_knockout_stage
where does the location of the northeastern part of the Catholic bishop NER die belong to which division?	John_James_Joseph_Monaghan
where is the capital of The name of the ship of NER	HMS_Somaliland_(K594)
who wrote the person and things that shares the same name with NER?	French_cruiser_Marseillaise_(1900)
which battle does the person and things that shares the same name with NER take part in?	Russian_destroyer_Marshal_Shaposhnikov
which title does the one that is after election of NER own?	United_States_Senate_election_in_Wyoming,_2000
which team does the captain of the club that NER belongs to belong to?	2014_FIFA_World_Cup_squads
which type of subdivision does the northwest of the stadium that NER takes place belong to?	2015_Copa_do_Brasil_First_Round
which language does the lyrics of the title of NER use?	Hero_(Super_Junior_album)
what awards NER's Candidate forward has won	Constitution_election_results_in_the_United_Kingdom_general_election,_1922
which dynasty does the legislature where the NER take place belong to?	2014_Davis_Cup_Europe/Africa_Zone_Group_I
what is the party of the incumbent of the title of NER?	Peter_Mandelson
what is the type of the sponsor of NER?	Super_Bowl_LI_halftime_show
what is the subdivisionRanks of The name of the vessel of NER	French_destroyer_Albatros
who will be the next Election after NER	Japanese_general_election,_1892
who is the predecessor of the successor of the descendant of NER?	Hemma
who is the heir of Election after NER	Hungarian_presidential_election,_2000
what is the profession of Lyrics of The title of NER?	Hero_(Super_Junior_album)
who is the Founder of the NER Dynasty Explained	Ladislaus_of_Naples
what do NER election winners do?	United_States_Senate_election_in_North_Carolina,_1998
what are the subdivision ratings of the NER ship name	French_brig_Cygne_(1806)
NER, Tommy Flanagan's album, what is the occupation of its creator	Flanagan's_Shenanigans
who was the Election after NER before	French_legislative_election,_1893
which timezone does the city in the south of NER belong to?	Bigues_i_Riells
what is the zoning of the location in the northwest of the city where NER is located?	National_Register_of_Historic_Places_listings_in_Los_Angeles_County,_California
what is the religion of the descendants of NER?	Pyinbya
NER, Wikimedia list article, what is the zoning of the location in the southern part of the autonomous region	List_of_historic_places_in_Westman_Region,_Manitoba
what is the name of the place west of NER's county?	Salcombe
who is the successor of the leader of NER?	Spanish_general_election,_1869
what is the name of the administrative district of Northwest of NER	Mieres,_Girona
what time zone does NER's Northwest location belong to?	Mieres,_Girona
What's wrong with The Winner of NER, A Battle Fought in China in 617?	Battle_of_Huoyi
who leads the people, things and things with the same name as NER?	HMCS_Sherbrooke
what is the positioning of the captain of the NER club location	UEFA_Euro_2016_squads
what is the next term of the father of NER	Konoe_long_ago
what is the title of the descendant of the ruler of NER	Turhan_Hatice_Sultan
what important positions Election has after NER	National_Justice_Party_leadership_election,_2001
what is the subdivision type of the north of the city that NER lives in?	National_Register_of_Historic_Places_listings_in_Box_Elder_County,_Utah
from what era came the Founders of the NER team	Heikki_Kovalainen
what is the name of the mother of a person or thing with the same name as NER, a ship	HMS_Alexandra_(1875)
what is the subdivisionRanks of The name of the vessel of NER	USS_Toucan_(AM-387)
where is the one that is after election of NER born?	Peruvian_general_election,_1985
what the battle of NER's ship's name is	French_ironclad_Courbet
who is the president of NER's alma mater	Shin_Chang-jae
which genre does the author of NER belong to?	They_All_Went_to_Mexico
which type of government does NER related events belong to?	Kingdom_of_Galicia_and_Lodomeria
which district does the north of the location of NER belong to?	2014_Maryland_Terrapins_men's_soccer_team
which timezone does the east of the northeast of NER belong to?	Sarral,_Tarragona
where is the operator of the stadium that NER takes place grounded?	2012-13_PAOK_FC_season
who are the descendants of NER's ship name	Queen_Charlotte_(1812_ship)
where is the location of the people, things and things with the same name as NER?	USS_LST-356
what constituency is NER's sponsor?	Stafford_150
who is Election's wife after NER	German_presidential_election,_1994
what time zone uses Northern NER Millionaires	List_of_American_football_stadiums_by_capacity
what does the chief town of NER belong to?	Canton_of_Tremblay-en-France
what is the nickname of Alma mater of NER	Mark_Van_Ameyde
who is the manager of the operator of the stadium that NER takes place?	Mexico_national_football_team_schedule_and_results
which label does the author of NER work for?	Stormy_Weather_(Lena_Horne_album)
what products do NER's sponsors have	Black_Opal_Stakes
what classification level do people, things and things with the same name as NER belong to?	HMS_Sparrow_(1828)
which timezone does the south of the location of NER belong to?	2011-12_in_Australian_soccer
what is the field of people whose names are used to name NER	Ehrlich_(crater)
which house does the legislature of the source location of NER belong to?	Reuss_(river)
what is the timezong of the city in the south of NER?	pine_trees
who is the chairman of the tenant of NER's venue	1994_JEF_United_Ichihara_season
which rank does the people, things and things with the same name as NER belong to?	USS_Swallow_(AM-65)
what is the title of The father of NER	Gyeongjong_of_Goryeo
NER's election winner who's successor	Italian_general_election,_1874
what is the religion of the father of NER?	Prince_Sutaro
what is the country of birth of the captain of the club that NER belongs to?	UEFA_Euro_2012_squads
NER, a genus of insects that represents which time zone a location in the west belongs to	Tanaecia
who is the general of the person in charge of NER?	INS_Trata
what is the club in which Captain of NER's club works	2004_African_Cup_of_Nations_squads
what are the affiliates of Alma mater of NER	Art_Peck
what is the Standard Settlement of NER's Northwest Site	2014-15_Washington_State_Cougars_women's_basketball_team
which one is known as the prime minister of the other name of the candidate of NER?	Portsmouth_North_(UK_Parliament_constituency)
what is the subdivision type of the south of the city that NER lives in?	National_Register_of_Historic_Places_listings_in_Salt_Lake_County,_Utah
who do the job after the one that is after election of NER	British_general_election,_1727
In NER Catalonia, Spain, what is the zoning of the place to the northwest of it	Corbera_de_Llobregat
who did a job before the one that is after election of NER?	Election_Committee_(Legislative_Council_constituency)_by-election,_2001
NER's election winner whose last term was	Rangitikei_by-election,_1880
where is the operator of the stadium that NER takes place located?	2009–10_Olympiacos_FC_season
what is the operator of the stadium that NER takes place named?	2014_CAF_Champions_League_qualifying_rounds
whose ancestor is the commander of NER?	The_Battle_of_Dingtao_(Eastern_Han_Dynasty)
which city does the operator of the stadium that NER takes place belong to?	2016–17_Sheffield_Wednesday_FC_season
who is the tenant of the successor of NER's venue?	2011_K_League_Championship
which type of subdivision does the south of the southwest of NER utah, united states, belong to?	Clarkston,_UT
where is the alma mater of the people, things and things with the same name as NER?	French_submarine_Joule
and who was influenced by the NER who or things with the same name	French_frigate_Descartes
where is the title of The name of the ship of NER	HMS_Black_Prince_(81)
what time zone uses Northern NER location	Colorado_State_Rams_football
whose ancestor is the father of NER?	Prince_Hisahito_of_Akishino
who is the predecessor of NER's election winner?	Japanese_general_election,_1892
what is the division of people or things with the same name as NER?	USS_Manderson_Victory_(AK-230)
which division does the person or thing with the same name as NER belong to?	HMCS_New_Westminster
what is the city of the operator of the NER venue?	2013-14_Barnet_FC_season
what is the subdivision name of the northwest of NER?	The_Palm_of_Cervello
who does the job after the parent of NER?	Buhe_(politician)
who do the job after the one that is after election of NER	United_States_Senate_election_in_Colorado,_2004
what is the title of the leader of NER	Spanish_general_election,_1869
who is the successor of NER's election winner?	Italian_general_election,_1874
NER, Wikimedia listing article, to which club the captain of its club location now belongs	2004_African_Cup_of_Nations_squads
The head of NER who are the current incumbents	Community_of_Saint_Anselm
what are the products of NER's sponsors	Hisense_4K_TV_300
who is the successor of the person and things that shares the same name with NER	SMS_Hindenburg
who is the successor of the one that is after election of NER?	German_federal_election,_1920
which battle is the people, things and things with the same name as NER involved?	HMS_Bramham_(L51)
which type of subdivision does NER's southern region belong to?	Castellnou_de_Bages
what is the club in which Captain of NER's club works?	2015_UEFA_European_Under-19_Championship_squads
what are the descendants of people, things and things with the same name as NER?	Queen_Charlotte_(1812_ship)
what dynasty did NER's father belong to?	Princess_Pingyang_(Han_dynasty)
what is the level of management to the southwest of The stadium where the NER took place	2011–12_Al_Ain_FC_season
what Election run agency is after NER	Romanian_general_election,_1922
Japanese nobleman (1536-1612) who was the successor of NER's father	Konoe_long_ago
who is the father of NER's ship name	HMS_Black_Prince_(81)
which battle does the people, things and things with the same name as NER take part in?	USNS_Lewis_B_Puller_(T-ESB-3)
which party does the parliament hold for the seat held by NER belong to?	indonesian_militant_democratic_party
what is the largest city with people, things and things that have the same name as NER?	Brazilian_monitor_Ceara
who is the successor of the people, things and things with the same name as NER?	King_George_(1785_ship)
where is the city of NER Station location	Lost@Sea
and NER what is the area to which people, things, things with the same name belong	ROKS_Cheonan
what is the language of the lyricist of the title of NER	Ride_Me_(album)
what is the ideology of the title of NER forward	Holger_K_Nielsen
who is the actor of Theme du NER	Skull_Island:_Reign_of_Kong
who is the predecessor of the person and things that shares the same name with NER?/ who is the father of the person and things that shares the same name with NER?	French_cruiser_Georges_Leygues
who are the producers of products related to the smartphone model NER	Xiaomi_Redmi_3
what is the previous generation of NER's election winner?	Bulgarian_election_election,_1986
who is the father of Le chef de NER	Anhalt-Dessau-Koethen
what is the zoning of the largest city in NER, a federal state in Brazil	Rio_Grande_do_Norte
what is the management level of North East NER location	2011_in_Ecuadorian_football
what is the management level of NER's ship's name	Brazilian_iron_clad_Tamandare
who is the male parent of the inaugural of the title of NER?	Paulo_Muwanga
what is the club in which Captain of NER's club works	2015_UEFA_European_Under-19_Championship_squads
which division does the administrative center of the birthplace of NER belong to?	River_Inny_(Leinster)
who is the predecessor of Election after NER	Mongolian_legislative_election,_2008
when is the people, things and things with the same name as NER born?	USS_Susan_B_Anthony_(AP-72)
where the birthplace of the city is from Captain of The NER Club	UEFA_Euro_2016_squads
what is the genre of the author of NER?	Flanagan's_Shenanigans
where is the cradle of the eponymous NER	Siddons_Patera
what is the religion of the administrative area that NER is responsible for?	Governor_of_Genoa
in which league The operator of The stadium where the NER took place will play?	2013-14_Luton_Town_FC_season
The name of the venue leader in the east of the football match NER is	2013_AFC_Champions_League_Final
which league does the operator of NER's venue play for?	2013-14_AEL_Kalloni_FC_season
where is NER's eponymous Alma Mater	Cavendish_(crater)
where is the birthplace of the city of Captain from NER's club	2014_FIFA_World_Cup_squads
Did you know that the common languages of Pays de NER were participating?	Battle_of_the_Tisza
who is the predecessors of Election after NER	German_federal_election,_1920
what is the subdivision rank of the person and things that shares the same name with NER (a barku)?	HNoMS_Myg
which eponymous domain belongs to NER	Van_der_Waals_(crater)
what the problem of The Descendant of NER is	Leopold_IV,_Duke_of_Anhalt
what are the affiliates of Alma mater of NER	Blas_C._Silva_Boucher
what time zone does the province of NER belong to?	Sakhalin_coal_mine
what are the countries of the event involved in NERparticipante	Empire_of_China_(1915–16)
what is the subdivision type of the southwest of the city that NER lives in?	National_Register_of_Historic_Places_listings_in_Utah_County,_Utah
which royal house does the person and things that shares the same name with NER belong to?	French_frigate_Cleopatra_(1781)
who is the mother of the next generation of the consort of the queen of ancient Egypt NER's consort?	Tyti
who is the spouse of the people, things and things with the same name as NER?	Fortitude_(1780_EIC_ship)
what dynasty belongs to a person or thing with the same name as the passenger ship NER on the Italian route?	MS_Giulio_Cesare
who has an important influence on NER's eponymous	Protagoras_(crater)
what is the club that the captain of the club that NER belongs to belongs to?	2015_FIFA_U-20_World_Cup_squads
what is the area covered by the Events in NER	Archduchy_of_Austria
where is the chief of The main organ of the chiefs of NER	Governor_of_Genoa
what are the things related to NER related things	sony_xperia_z3+
NER, the city of Tarragona, Spain, to which division does its northwest location belong	Batea,_Tarragona
NER's election winner who's successor	United_States_Senate_election_in_Vermont,_1980
what is the timezong of the southeast of the location of NER?	France_national_football_team_results_(2000–present)
which division does the location in the west of where NER died belong?	John_James_Joseph_Monaghan
First Lady of the United States; Wife of the 37th President of the United States NER (1912-1993) where was the title of successor to Pat Nixon	Richard_Nixon
what occupation is the source of the NER name?	Tikhonravov_(crater)
what dynasty does NER's Life of Location belong to?	Sobieski_(train)
what is the region of the person or thing with the same name as NER?	HMCS_Sherbrooke
what important positions Election has after NER	Labor_Party_(UK)_deputy_leadership_election,_2015
which rank does the people, things and things with the same name as NER belong to?	USS_Shrike_(MHC-62)
what is the religion of the person or thing with the same name as NER?	SAS_President_Kruger_(F150)
what is the title of The Father of NER	Princess_Huayang_(Emperor_Xiaowen_of_Northern_Wei_Dynasty)
who operates the successor of the stadium that NER takes place?	2014-15_KNVB_Cup
which club does the captain of the NER club location now belong to?	2012_Africa_Cup_of_Nations_squads
where is the title of the predecessor of NER located?	Ronald_William_Gainer
which type of subdivision does the northeast of the city that NER lives in belong to?	National_Register_of_Historic_Places_listings_in_Weld_County,_Colorado
NER, the season of a football team, where is the city of the operator of its venue	2012–13_Aris_Thessaloniki_FC_season
which house does the legislature of the location of NER belong to?	1974_FIFA_World_Cup_qualifying_–_UEFA_Group_1
where is the event that starts the user of NER invented by sir hiram maxim in 1884, located?	Maxim_gun
which place is called as the subdivision of the west of the northwest of NER?	Speaker,_Utah
who is the founder of the The name of the ship of NER	Japanese_cruiser_Takao_(1930)
what is the person and things that shares the same name with NER known for?	USS_Gatling
NER, the tenant of the football team's successor for a season, its venue	2012_Gyeongnam_FC_season
who is the successor of the person or thing related to the result of NER	Battle_of_Tanshebrai
who is the predecessor of The leader of NER	Mongolian_legislative_election,_2016
who will be the next Election after NER	Estonian_election_election,_2003
what is the map caption of the people, things and things with the same name as NER (a barku)?	USS_Neponset_(ID-3581)
where is the Alma Mater of Election after NER	United_States_Senate_election_in_Georgia,_2014
what are the titles of the incumbent incumbent of the title of Bangladesh President NER?	Shahabuddin_Ahmed
what is the traditional form of the The operator of The stage where the NER took place	2014_CAF_Champions_League_qualifying_rounds
what is the label of Chronology of NER	The_Milt_Jackson_Big_4
which rank does the person and things that shares the same name with NER belong to?	SMS_Seeadler_(1888)
what is the alma mater of the person whose name is used to name NER	Schliemann_(crater)
which ethnic group does the previous generation of NER's lyricist belong to?	Prudence_Liew_(album)
what club Captain of NER's Club worked at?	2015_UEFA_European_Under-17_Championship_squads
what is the country of NER's alma mater?	Gerard_M_Burns
which one is known as the prime minister of the one that is after election of NER	Angolan_legislative_election,_2012
NER's location what division does the location in the west belong to?	Bannered_roads_of_US_Route_40
what are the regions of NER-related events in isolated human groups	Tanukhids
NER where are its main towns located	Canton_of_Ribemont
where is the city of The operator of The stadium where the NER took place	2008–09_Coventry_City_FC_season
what is the time zone of the same name of the US Navy Schiphol van der NER	USS_Harpers_Ferry_(LSD-49)
what dynasty does NER Nationality Life belong to?	Vanek_(surname)
which state does the alma mater of NER belong to?	Oval_Jaynes
where is the place where the person or thing with the same name as NER died	Otto_Hahn_(ship)
who is the successor of NER's namesake?	French_cruiser_Georges_Leygues
where is the place where the person whose name was used to name the NER died	Dewar_(crater)
where is the alma mater of the people, things and things with the same name as NER lead ship of its class?	USS_Arleigh_Burke
who is the tenant of the predecessor of the stadium that NER takes place?	2009_end-of-year_rugby_union_internationals
what is the region of the person or thing with the same name as NER?	USCGC_Snohomish_(WYTM-98)
what time zone is used in South of NER lands of the ebro, tarragona province, spain?	El_Pinell_de_Brai
who is the predecessor of NER's election winner?	German_presidential_election,_1994
where the alma mater of Election is after NER	Peruvian_general_election,_1985
what is the area of a mountain range in Utah County, Utah, USA, where the location northeast of the city NER is located.	Lake_Mountains
what is the name of the leader of NER with the same name?	HMCS_Ville_de_Quebec_(K242)
what is the timezone used by Club that Est de NER is part of	Figols_i_Alinyà
what is the language used in Cities affected by NER	2006_Yogyakarta_earthquake
who did a job before the one that is after election of NER?	Manila_local_elections,_2016
what are the famous works of people, things and things with the same name as NER?	CS_Faraday_(1923)
which club currently belongs to Captain of NER's club	2009_FIFA_U-20_World_Cup_squads
what is the title of the predecessor of the location of NER	2015_Shanghai_Greenland_Shenhua_FC_season
who rented the venue of the NER club	2015_WBSC_Premier12_rosters
what do the creators of NER do?	BEST_(After_School_album)
where is the main town of NER in a French state (as of March 2015)	Canton_of_Neuilly-Saint-Front
what is the club in which Captain of NER's club works?	2009_FIFA_U-20_World_Cup_squads
what classification level does the person or thing with the same name as NER belong to?	USS_Searaven_(SS-196)
where did NER play and get a job?	Hyon_Yong-chol
where is the address of The operator of The stadium where the NER took place	2016_Buriram_United_FC_season
do You Know what Language Lyrics Of NER's Title Is Using	Ride_Me_(album)
which dynasty does the successor of the descendant of NER belong to?	Charles_Louis,_Hereditary_Prince_of_Baden
which musical instrument NER timeline used	Parachilna_(album)
what is the zoning of the location in the southeast of NER Utah, USA?	Meadow,_U.T
NER where is the address of the tenant of its venue	2012_Mito_HollyHock_season
in which league The operator of The stadium where the NER took place will play	2011–12_Ipswich_Town_FC_season
who leads the person and things that shares the same name with NER	HMS_St_Helena_(K590)
which place is called as the subdivision of the northeast of the place that NER takes place?	1972-73_New_York_Knicks_season
what is the division of people, things, and things with the same name as NER?	HMCS_Guelph
who did a job before the one that is after election of NER?	South_African_general_election,_1977
who is the predecessor of the one that is after election of NER?	French_legislative_election,_1914
NER's election winner whose last term was	Italian_general_election,_1992
what is the party of the legislature of the place that NER takes place?	2015-16_CB_Gran_Canaria_season
what is the operator of the venue of NER named?	Mauritius_national_football_team_results_(2010–19)
where is the alma mater of NER located?	Albert_Camus
what is the name of the administrative district of Western NER Millionaires	National_Register_of_Historic_Places_listings_in_Millard_County,_Utah
who is the President of Election after NER	Abkhazian_presidential_election,_2014
NER where are its main towns located	Canton_of_Gagny
who is the predecessor of The front of Candidate of NER	Swiss_Council_of_States_elections,_2007
what is the profession of NER Timeline	Themes_from_Calmi_Cuori_Appassionati
which institution is the alma mater of American sculptor NER affiliated to?	Wayne_Chabre
who does the name included in the NER influence?	Empedocles_(volcano)
who is the predecessor of the one that is after election of NER?	French_legislative_election,_1914
where is the city of The operator of The stadium where the NER took place	2016–17_UEFA_Europa_League_qualifying_phase_and_play-off_round
what are the descendants of people, things and things with the same name as NER?	RV_Kronprins_Haakon
where do the leaders of the NER take office	French_regional_elections,_2015
which party belongs Election after NER	Guatemalan_general_election,_2011
what is the timezong of the northeast of the place that NER takes place?	2016_WNBA_Playoffs
who are the affiliates of Alma mater de NER	Patricia_Clavin
what is the office of the one that is after election of NER?	National_Liberation_Party_presidential_primary,_2009
what is the lyrics of the title of NER?	The_Beat_Goes_On_(Super_Junior_D&E_album)
who does the job after the person and things that shares the same name with NER?	President_El_Hadj_Omar_Bongo_(ship,_1978)
what is the office of the leader of the label of NER?	Hong_Kong_legislative_election,_2016
who is the descendant of the person, thing, thing with the same name as NER?	King_George_(1785_ship)
where is the Alma Mater of Election after NER	Lithuanian_election_election,_2000
which region is the event involved in NER?	Archduchy_of_Austria
who is the father of the leader of NER?	Spanish_general_election,_1869
what it the product of the sponsor of NER?	Hisense_4K_TV_300
where NER's election winner takes office	Northern_Cyprus_presidential_election,_2015
where did the eponym of NER study?	Arrhenius_(lunar_crater)
which religion does the parent of NER believe?	Didit_Hediprasetyo
Part of what is the person, thing, thing with the same name as NER	French_ship_Austerlitz_(1852)
what is the management level of NER ship name brought to us for analysis; now museum?	German_corvette_Hiddensee
what is the industry of NER's sponsor?	Louis_Schwitzer_Award
who is the owner of the successor of NER's venue?	2013–14_UEFA_Champions_League_group_stage
what is the type of creator of NER	Dirt_Sledding
what is the subdivision rank of the people, things and things with the same name as NER?	HMS_Sparrow_(1828)
NER, Wikimedia listing article, what team is the captain of its club location	2010_FIFA_World_Cup_squads
what is the subdivisionRanks of The name of the vessel of NER	USS_Rattlesnake_(1813)
which place does the division that NER belongs to take place?	2009-10_in_Australian_soccer
what is the title of the person and things that shares the same name with NER	Italian_ironclad_Enrico_Dandolo
what club Captain of NER's Club worked at?	2012_Africa_Cup_of_Nations_squads
what party is the legislature of NER's nationality?	Vanek_(surname)
what is the Homeland of Captain of The NER Club	1999_FIFA_World_Youth_Championship_squads
what is the common language of the person and things that shares the same name with NER?	French_destroyer_Tonkinois
which party does the legislature of the location of NER belong to?	Uzbekistan_national_football_team_non-international_results
what is the stadium that hosted the Events in NER	UEFA_Euro_2000_Final
what time zone uses West of Southeastern NER utah, united states?	Levan,_UT
what time zone is in Northwest of NER	The_Senia
what is the time zone of the region south of NER Spain	Polynya
who rules the father of NER?	Princess_Hongnong
who is the successor played by the Hong Kong politician NER?	Steven_Poon
who is next to the The father of NER	Liu_Boyuan
who is the successor of the person, thing, thing with the same name as the ship NER?	French_cruiser_Georges_Leygues
what is the deathpalce of the eponym of NER?	Haldane_(lunar_crater)
what religion the Generals of the participating NERs believe in	Second_Rif_Damascus_Offensive
what is the subdivision type of the southeast of the city that NER lives in?	San_Pitch_Mountains
who is the predecessor of the incident in which NER is involved?	Gurjara-Pratihara
where is the title of Election after NER	Northern_Cyprus_presidential_election,_2015
what is NER's Customer Dynasty?	Royal_Spring,_Warsaw
which battle does the people, things and things with the same name as NER take part in?	German_destroyer_molders
what is the surrounding city of the region of the nationality of NER	Luo_Ji
who leads the event happened in NER?	Germania_Superior
where is the constituency of the Northern NER location	1953–54_Colchester_United_FC_season
how to address the children of NER?	Anwar_Ibrahim
who leads the legislature of the locale of NER?	Montana_Rail_Link
what awards The first of NER's title won?	Nathan_Farragut_Twining
where did the person, thing, and thing with the same name as NER die?	HMS_Bigbury_Bay_(K606)
NER Catalonia, Spain, to which time zone its northwest location belongs	Gurb
what are the descendants of NER's generals?	The_Battle_of_Dingtao_(Eastern_Han_Dynasty)
what is the famous work of the person named NER?	Conon_(crater)
who are the teams participating in the important events that NER participates in?	2010–11_Queens_Park_Rangers_FC_season
which battle does the person and things that shares the same name with NER take part in?	USS_Bainbridge_(DDG-96)
which rank does the people, things and things with the same name as NER belong to?	USCGC_Mallow_(WLB-396)
where is the alma mater of NER located?	Frank_Darling_(architect)
what is the other name that the alma mater of NER is known as?	Art_Peck
which rank does the people, things and things with the same name as NER belong to?	USS_Abele_(AN-58)
where is the birthplace of the one that is after election of NER?	Italian_general_election,_1874
who is the predecessor of Election after NER	Central_Tibetan_Administration_general_election,_2016
what is the title of The father of NER	Konoe_long_ago
who is the predecessor of the incumbent of the title of NER?	Zhu_De
what language the singer who played for NER uses	Boysitter
what is the subdivision type of the city in the south of NER spain?	Bigues_i_Riells
what is the title of the predecessor of the candidate of NER?	United_States_House_of_Representatives_elections_in_Louisiana,_2014
what is the party of the person, thing, and thing with the same name as the gear-class destroyer NER?	USS_Joseph_P_Kennedy_Jr_(DD-850)
where did the voters for the NER's election winner come from?	Hong_Kong_Island_by-election,_2000
where is the city of Alma mater from NER	Jill_Garner
what is the area of the place in the northwest of NER	Pepingen
in which country is the Alma mater of NER	Wayne_Chabre
do You Know what Language Lyrics Of NER's Title Is Using	Ride_Me_(album)
which label does the location country of NER have?	Bled_Castle
what is the type of Alma mater of NER	Ed_Jackson_(Tennessee_politician)
1915 events of the same name on the Royal Navy's Queen Elizabeth-class battleship NER	HMS_Malaya
who was nominated by Candidate from The constituency of NER	Peter_Shiu
what is the subdivision rank of the people, things and things with the same name as NER?	HMNZS_Moa_(T233)
who is the heir of Election after NER	Romanian_general_election,_1922
what is the name of the mother of a person or thing with the same name as NER?	USS_Troup_(1812)
which club does the captain of the club that NER belongs to belong to?	2015_FIFA_U-20_World_Cup_squads
who founded the owners of NER club locations?	2006_World_Baseball_Classic_rosters
what is the region of the person or thing with the same name as NER?	HMCS_Esquimalt_(J272)
what time zone uses The Northeast of NER Millionaires	National_Register_of_Historic_Places_listings_in_Los_Angeles_County,_California
what is the occupation of the author of NER?	Identity_(Zee_album)
who is the one that is after election of NER?	Italian_general_election,_1874
what is the time zone of NER Northwest	Mieres,_Girona
what the agency headed by The head of NER is?	House_of_Assembly_of_Saint_Vincent_and_the_Grenadines
who is the spouse of the person or thing with the same name as NER?	King_George_(1785_ship)
what descendants did the father of the Empress of Japan (680-748) NER have	Empress_Gensho
where is the alma mater of the predecessor of the candidate of NER?	Results_of_the_Australian_federal_election,_2016_(Victoria)
who is the predecessor of Wallner's election winner?	South_African_general_election,_1977
where is the people, things and things with the same name as NER born?	Otto_Hahn_(ship)
which label does the author of NER belong to?	Girls_Just_Wanna_Have_Fun_(Shaggy_song)
A town in Box Elder County, Utah, U.S.A., the location in the east of NER, the location in the south, and which division does the location belong to?	Howell,_UT
what are the sponsors of the car race NER in Daytona, USA?	24_Hours_of_Daytona
what is the birthplace of The NER Coach	Yevgenia_Medvedeva
who are the generals participating in the The name of the NER ship	French_ship_Rivoli_(1810)
who are the descendants of NER-related events?	Gurjara-Pratihara
where does the title of NER's predecessor belong?	Lai_Tung-kwok
what are the descendants of NER's namesake?	King_George_(1785_ship)
what are the products of the NER team	Thomas_Pages
who is the predecessors of Election after NER	United_States_Senate_election_in_Rhode_Island,_2012
who will host NER's Title Podcast next?	The_Complete_Guide_to_Everything
what the problem of The Descendant of NER is	William,_Prince_of_Hohenzollern
Whose child is the name of NER?	French_submarine_Calypso
what party did the predecessors of the previous generation of the French statesman (1907-2000) NER belong to	Pierre_Pflimlin
what zip code is used for people, things and things with the same name as NER	USS_Winnemucca_(PC-1145)
what is the time zone for the southern region of NER	Lliça_de_Vall
what is the name of the administrative division of Capital of NER's location	Thebes,_Egypt
who is the heir to NER's ship name	Cornwallis_(1787_ship)
what was the name of the institution before the participating countries of the war NER?	Irish_Civil_War
which office does the one that is after election of NER belong to?	National_Justice_Party_leadership_election,_2001
what are the subdivision ratings of the NER ship name	HNoMS_Myg
what is the currency of the event that starts the location of NER?	2010-11_in_Spanish_Football
what is the origin of NER's name known for?	Fabry_(crater)
which instrument does the author of NER play?	Etta_James_(1973_album)
what is the flag event established in the country where NER is located Northern Ireland	Belfast_City_Hall
do You Know what Language Lyrics Of NER's Title Is Using	The_Beat_Goes_On_(Super_Junior_D&E_album)
what is the label of The area where NER is used?	Ongota
what is the title of the consort of the ruler of NER	Hatice_Muazzez_Sultan
what is the office of the candidate of the predecessor of NER?	Prince_(constituency)
which party does the legislature where the NER is held belong to?	2005_Davis_Cup_World_Group_Play-offs
where is the death place of NER's ship name	USS_Susan_B_Anthony_(AP-72)
NER, 1892, who is the successor to the winner of an election held in Japan in 1892	Japanese_general_election,_1892
which party does the one that is after election of NER belong to?	Iranian_legislative_election,_1956
where did the leader of the label of NER study?	Hong_Kong_legislative_election,_2016_(Hong_Kong_Island)
in which city is the operator of the venue of NER?	2014–15_Panathinaikos_FC_season
what the battle of NER's ship's name is	USNS_Lewis_B_Puller_(T-ESB-3)
what type of school is NER's alma mater?	Mark_Van_Ameyde
what is the label of the area where NER is used?	Ongota
what is the occupation of the successor of the author of NER?	My_Love:_Essential_Collection
which type of government does the event that starts the location of NER belong to?	Honduras_national_football_team_results_(1990–99)
in which country is the representative of the venue of NER?	1978_Kangaroo_tour_of_Great_Britain_and_France
NER what is the division of the area to the northwest of it	Oliola
what is the profession of Lyrics of The title of NER?	Hero_(Super_Junior_album)
what type of NER Timeline	Girls_Just_Wanna_Have_Fun_(Shaggy_song)
where is the birthplace of the person named NER	Leakey_(crater)
who is the publisher of NER's sponsor?	WWE_Breaking_Point
NER's election winner whose last term was	Kiribati_presidential_election,_2012
where is the one that is after election of NER located?	United_States_Senate_election_in_Vermont,_1980
what is the party of the legislature of the locale of NER?	Mediolanum_(train)
where is the Alma Mater of Election after NER	Tunisian_Constituent_Assembly_election,_2011
where is the captain of the club that NER belongs to born?	2010_FIFA_World_Cup_squads
what is the name of the administrative district of The north of The stadium where the NER took place	1975_Rugby_League_World_Cup
who takes the place of the father of NER?	Princess_of_Henan_(Northern_Zhou_Dynasty)
which division does the southern city of NER belong to?	Garrigues_(comarca)
where is the title of The front of The stadium where the NER took place	2013_Chinese_FA_Cup
what the problem of The Winner of NER is	Zhou_Attack_on_Quwo
what Happened in the Time of NER's Ship's Name	Bunker_Hill_(1778_ship)
where is the birthplace of Election after NER	Haitian_presidential_referendum,_1961
which division does the location in the southwest of NER's city belong to?	CBTK-FM
in which state is the election winner for Wallner?	United_States_Senate_election_in_Kansas,_2014
who married the person and things that shares the same name with NER?	HMS_Osiris_(N67)
who is the leader of the NER ship name	HMS_Nyasaland_(K587)
what is the nationality of the origin of the NER name?	Donne_(crater)
what is the next term of The winner of NER	Battle_of_Tanshebrai
who is the leader of the NER's ship name	Type_626_tanker
what is the occupation of the creator of NER	Ragga_Bomb
where is the person or thing with the same name as NER	Spirit_of_Kangaroo_Island
who is the male parent of the successor of the descendant of NER?	Josephine_of_Leuchtenberg
who will be the next Election after NER	Spanish_general_election,_1931
which title does the country that is spoken NER belong to?	Baekje_language
which place is called as the subdivision of NER's southern region?	Polynya
what titles do Wallner's election winners hold?	United_States_Senate_election_in_North_Carolina,_1990
what condition is Alma mater from NER	Paul_Bailey_(politician)
what are the titles of NER's generals?	United_States_Southern_Command
who is the male parent of the person and things that shares the same name with NER?	Scottish_warship_Margaret
NER what is the name of the chairman of the tenant of its venue	1994_JEF_United_Ichihara_season
where is the birthplace of NER's election winner	Kiribati_presidential_election,_2012
who is the heir of Election after NER	Philippine_presidential_election,_1953
which house does the last of the descendant of NER belong to?	Juan_Carlos_I_of_Spain
what the job of the Founders of the NER team is	Giancarlo_Fisichella
who will be the next NER Timeline dj quik, lord tariq and peter gunz?	The_Way_It's_Goin'_Down
which division does the administrative center of NER's location belong to?	2013–14_Videoton_FC_season
which team does the captain of the NER club location play for?	2009_FIFA_U-20_World_Cup_squads
which sport does the captain of the club that NER belongs to play?	2015_UEFA_European_Under-17_Championship_squads
what is the alma mater of NER's election winner	Guatemalan_general_election,_2011
NER which district does its main town belong to	Canton_of_Gagny
who is the father of NER's ship name	RV_Kronprins_Haakon
which type does the location of the national team that NER belongs to belong to?	Heinrich_Schmidtgar
which royal house does the person and things that shares the same name with NER belong to?	Egyptian_sloop_El_Amir_Farouq
what is the nationality of the head of NER	Government_of_National_Salvation
who is the leader of the legislature of the region of NER?	Keokuk_Limestone
in which city is NER's alma mater?	Shin_Chang-jae
what time zone is the location in the southeast of where the NER takes place?	2002-04_European_Nations_Cup_Second_Division
and NER what is the war in which a person or thing with the same name participated	USS_Bainbridge_(DDG-96)
what is the instrument that the author of NER plays?	Gone_Girl_(soundtrack)
what is the address of the operator of the venue where NER is held?	2014–15_Olympiacos_FC_season
who is the manager of the operator of NER's venue?	2013-14_Zamalek_SC_season
who is the writing team behind NER Timeline dj quik, lord tariq and peter gunz?	The_Way_It's_Goin'_Down
which eponymous area of NER belongs to	Schliemann_(crater)
who is the successor of the person and things that shares the same name with NER	RMS_Queen_Mary_2
who do the job after the one that is after election of NER	United_States_Senate_election_in_Wyoming,_2000
what time zone does NER's Northwest location belong to?	Espot
The field the person whose name is used to name the NER belongs to	Kamerlingh_Onnes_(crater)
where does the person and things that shares the same name with NER take place?	French_destroyer_Valmy
what is the currency of the event that starts the venue that NER is held?	2014_Davis_Cup_Americas_Zone_Group_I
who will be the next Election after NER	Spanish_general_election,_1931
which product belongs to the team that won NER	Thomas_Pages
who is the mother of the successor of the descendant of the Prince of Denmark (born 1969) NER	Prince_Joachim_of_Denmark
what instruments did the creators of NER use	Parachilna_(album)
what is the level of management at The name of the ship of NER	HMCS_Peterborough
who is the leader of the Life of Place of the World Day of NER	2016_NBA_Summer_League
who the parents of NER's ship name are	French_Frigate_Artemise_(1829)
what is the timezone used by Corps of NER's Title	George_Wallace_Jr.
where is the birthplace of the person named NER	Volta_(crater)
in which city is the operator of the venue of NER?	2013-14_FA_Cup
which dynasty does the legislature of the locale of NER belong to?	Transalpin
which club does the captain of the club that NER belongs to belong to?	2015_FIFA_U-17_World_Cup_squads
what is the occupation of the author of NER?	Qualquer_Coisa
In what condition is NER's Alma mater	Edward_McAlexander
what type of subject is NER	The_Wizarding_World_of_Harry_Potter_(Universal_Studios_Japan)
who was influenced by the person whose name was used to name NER?	Sherrington_(crater)
what is the famous work of NER's eponymous	Maclaurin_(crater)
what city is the alma mater of American basketball coach NER?	Greg_Gard
who is the spouse of the people, things and things with the same name as NER?	SS_Prinses_Astrid
where is the southern region of NER?	Vallfogona_of_Ripolles
what is the subdivision name of the west of the location of NER?	Okanagan_International_Marathon
Wikimedia listing article which team does the captain of the NER club location play for?	1999_FIFA_World_Youth_Championship_squads
who is the predecessor of Election after NER	Election_Committee_(Legislative_Council_constituency)_by-election,_2001
what is the national team captain of your next NER club	Valerie_Adams
NER what the operator of its venue is named for	2013-14_Zamalek_SC_season
what is the management level of West of South East of NER	Holden,_U.T
what is the religion of the leaders of NER?	Al-Muthanna_governorate_election,_2013
which timezone does the southeast of the home to NER belong to?	2015-16_Utah_State_Aggies_men's_basketball_team
what are the affiliations of NER's alma mater	Joanne_Grant
in which league The operator of The stadium where the NER took place will play?	2016–17_Sheffield_Wednesday_FC_season
what is the classification level of a person or thing with the same name as NER	USS_Toucan_(AM-387)
what the program format of NER's L'avant de Paroles is?	Prudence_Liew_(album)
what is the time zone used by North West NER's location	2017_Lamar_Hunt_US_Open_Cup_qualifying
which place is called as the subdivision of the northeast of the birth place of NER?	John_Rostek
what team is the captain of the NER club location	Japan_national_football_team
who operates the successor of the stadium that NER takes place?	2014-15_UEFA_Europa_League_knockout_phase
what is the job of the lyrics of the title of NER?	Ride_Me_(album)
where the birthplace of NER's ship's name is?	French_ship_Somme_(A631)
where is the birthplace of NER's ship name, un barku den fransia?	French_cruiser_Foch
what is the name of the administrative district of South East of NER Millionaires	National_Register_of_Historic_Places_listings_in_Utah_County,_Utah
what is the timezong of the southwest of the south of NER utah, united states?	Manila,_UT
what time zone is the location south of NER in?	Llica_d'Amunt
what region does NER's province belong to in the country?	Hanaoka_mine
where are the heirs of The father of NER	Trin_Kiem
where is the operator of the venue of NER?	2012-13_Greek_Football_Cup
what type of company is NER's sponsor?	Academy_Award_(radio)
what are the important positions held by NER ship name	USS_Nitze
what are the iconic places for people, things and things with the same name as NER?	French_ship_Polyphemus_(1815)
which rank does the people, things and things with the same name as NER belong to?	USS_Toucan_(AM-387)
what dynasty does NER User's Life belong to?	20×138mmB
who is the first predecessor of the title of NER?	Margaret_Beckett
which place is called as the subdivision of the northeast of the stadium that NER takes place?	1998_Seattle_Seahawks_season
what time zone is used in the southern cities of NER	Montgai
who are the descendants of The name of the ship of NER	Italian_battleship_Emanuele_Filiberto
NER where is the city of the operator of its venue	2014–15_Accrington_Stanley_FC_season
which league does the operator of the stadium that NER takes place belong to?	2008–09_Everton_FC_season
where was the birthplace of the founder of the team of Finnish racing driver NER	Heikki_Kovalainen
what is the administrative district of Principal city of NER	Canton_of_Remiremont
what is the next term of the Parents of NER	Franklin_Delano_Roosevelt_III
which party does the one that is after election of NER belong to?	Persian_legislative_election,_1906
who is the manufacturer of things related to NER?	sony_xperia_z3+
who is issued by the people, things and things with the same name as NER?	Russian_cruiser_Gerzog_Edinburgski
what is the management level of NER south	Vilallonga_de_Ter
in which region the person whose name is used to name the NER is	Penticton_(crater)
which field does the origin of NER's name work in?	Harden_(crater)
who is the predecessors of The leader of NER	United_States_of_Indonesia
what is the level of management at Northwest of NER	Vilada
who is influenced by the person whose name is used to name NER?	Mach_(crater)
where is the birthplace of the person and things that shares the same name with NER?	RV_Neil_Armstrong_(AGOR-27)
which label does NER related events belong to?	UEFA_Women's_Euro_2013_Final
the area covered by the NER Site Zoning Types	2015-16_Kansas_Jayhawks_women's_basketball_team
A town in Sampitt County, Utah, USA, what is the area of NER, the location in the south, and the location in the northwest?	Wales,_Utah
who owns your next club from The stadium where the NER took place	1997–98_Juventus_FC_season
which city does the operator of the stadium that NER takes place belong to?	2011–12_Olympiacos_FC_season
what is the country of the caption of the photo of The stadium where the NER took place	2009-10_LV_Cup
what kind of company is the sponsor of NER?	Academy_Award_(radio)
what is the The life of The stadium where the NER took place	2013-14_Zamalek_SC_season
what are the descendants of NER's principals?	Royal_Palace_of_Ficuzza
what is the origin of NER's name known for?	Shoemaker_(lunar_crater)
who the creator of The NER Related Thing is	Supergirl_(TV_series)
what is the University of NER Title Writer?	List_of_Star_Trek:_Deep_Space_Nine_episodes
what is the fame of the person whose name was used to name NER?	Davy_(crater)
what is the subdivisionRangs of The name of the ship of NER, un french lead ship of chacal-classes?	French_destroyer_Chacal
what is the instrument that the author of NER plays?	The_Piano_Style_of_Nat_King_Cole
where is the location of the home to NER located?	2012-13_Saint_Louis_Billikens_men's_basketball_team
where is the alma mater of The person who affects NER patriot and republican?	Giuseppe_Garibaldi
what are the important positions of Election after NER	Central_Tibetan_Administration_general_election,_2016
who is the predecessor of NER's election winner?	California_gubernatorial_election,_1863
what is the subdivision name of the southwest of the city that NER lives in?	National_Register_of_Historic_Places_listings_in_Horry_County,_South_Carolina
where the operator of Your next club is The stadium where the NER took place?	Germany_national_football_team_results_(2000–present)
where is the operator of the venue of NER?	2014–15_AEL_Kalloni_FC_season
what is the famous work of NER's eponymous	Mach_(crater)
what is the level of management at NER's South Site	2011-12_Utah_State_Aggies_men's_basketball_team
what is the leader title of the person and things that shares the same name with NER?	HMCS_Levis_(K400)
which team does the captain of the club that NER belongs to belong to?	2016_UEFA_European_Under-17_Championship_squads
who is before the parent of NER	Franklin_Delano_Roosevelt_III
NER's location what area is the northern city in?	2012-13_Real_Madrid_CF_season
what NER's successor club location is named for	Henry_Rono
which type does the person and things that shares the same name with NER belong to?	Italian_cruiser_Etna
where is the person whose name is used to name NER born?	Martial_(crater)
what is the classification level of the same name for NER	USS_Gull_(AMS-16)
what is the name of the alma mater of the person named NER?	Cayley_(crater)
which club does the captain of the club that NER belongs to belong to?	1999_FIFA_World_Youth_Championship_squads
where the Northeast of NER site is	2015-16_Houston_Cougars_women's_basketball_team
where is the alma mater of NER located?	James_Boyd_Hawkins
where NER's election winner takes office	Democratic_Party_(HK)_leadership_election,_2002
With NER it has the same name of people, things, things belong to which division	French_ship_Ville_de_Nantes
who is the last person to run the NER position for the American college football team?	2014_BYU_Cougars_football_team
NER, a Chinese politician (1886-1975) who was the chairman he played	Dong_Biwu
who is the predecessor of the leader of NER?	Albanian_Kingdom_(1928–39)
who created the products or works related to NER	Supergirl_(TV_series)
what club does Captain of NER's Club	2009_FIFA_U-17_World_Cup_squads
what classification level does the same name of NER belong to?	Marsouin_(1788_ship)
NER's election winner whose last term was	German_presidential_election,_1994
who is earlier than the one that is after election of NER	South_African_general_election,_1977
what is the flag event established in the country where NER is located?	International_Association_of_Inventions'_Unions
what is the leader name of the people, things and things with the same name as NER?	HMCS_Sherbrooke
which type of subdivision does the northeast of the city that NER lives in belong to?	National_Register_of_Historic_Places_listings_in_San_Juan_County,_Utah
which league does the operator of the stadium that NER takes place belong to?	2013-14_Barnet_FC_season
who is the heir to NER's ship name	USS_Windom_(1896)
who is the predecessor of NER's election winner?	First_Māori_elections
where is NER's eponymous Alma Mater	Schliemann_(crater)
which dynasty does NER's father belong to?	Prince_Hisahito_of_Akishino
what era did the eponym of NER come from	Lippershey_(crater)
which label does the location country of NER have?	Bled_Castle
what is the time zone of the southern city of NER	Sant_Fost_de_Campsentelles
which rank does the person and things that shares the same name with NER belong to?	USS_Rattlesnake_(1813)
who is the president of The name of the ship of NER	USRC_Dexter_(1830)
what is the famous eponymous work of NER	Cayley_(crater)
what titles do NER's election winners hold?	United_States_Senate_election_in_West_Virginia,_2014
what is the timezong of the northwest of NER?	Siurana,_Alt_Emporda
where is the city of Alma mater from NER	James_Haven
which timezone does the south of the city that NER lives in belong to?	National_Register_of_Historic_Places_listings_in_Salt_Lake_County,_Utah
who gave birth to the people, things and things with the same name as NER?	French_frigate_Hebe_(1782)
what time zone is the location south of NER in?	Siurana,_Alt_Emporda
NER, U.S. citizen residing outside the U.S., to which party the legislature of the region to which they belong	American_diaspora
what are the descendants of the person or thing with the same name as NER?	French_frigate_Cleopatra_(1781)
what is the name of the administrative division of Southern NER County	List_of_National_Historic_Landmarks_in_Massachusetts
who is the predecessor of Election after NER	Angolan_legislative_election,_2012
NER, the season of a football team, which country its position represents	2012-13_Chelsea_FC_season
what is the type of Alma mater of NER	Lapthe_Flora
who is the candidate for the title of NER now?	Constitution_election_results_in_the_United_Kingdom_general_election,_1923
who is the leader of the Nationality life of NER	Vanek_(surname)
what is the subdivision rank of the person and things that shares the same name with NER?	French_brig_Amarante_(1793)
what is the management level of South East NER location	List_of_Lambda_Chi_Alpha_chapters
what titles do children of NER have?	Jing_Pu
where are the events included in the NER held?	2009-10_in_Australian_soccer
NER's events speak the common language	Kingdom_of_Galicia_and_Lodomeria
where is the captain of the club that NER belongs to born?	UEFA_Euro_2012_squads
who is before the cause of NER?	Battle_of_Tanshebrai
to whom the person or thing with the same name as NER owes allegiance	ORP_General_Tadeusz_Kosciuszko
what is the occupation of the successor of the author of NER?	My_Love:_Essential_Collection
what is the subdivision type of the south of the location of NER?	2014_Santos_FC_season
what is the name of the national capital of The name of the ship of NER	HMS_Ascension_(K502)
what type of creators are NER	Etta_James_(1973_album)
in which city is the operator of the venue of NER?	2013-14_Luton_Town_FC_season
what is the timezong of the southwest of the city that NER lives in?	National_Register_of_Historic_Places_listings_in_Weld_County,_Colorado
what is the subdivision name of the city in the south of NER?	That,_Catalonia
what is the currency of the event that starts the location of NER?	1962_CONCACAF_Champions'_Cup
what is NER's eponymous legislature	MV_Prins_Harald
which club does the captain of NER's successor belong to now?	Valerie_Adams
which religion does the country that is affected by NER believe?	2006_Yogyakarta_earthquake
NER, the American college basketball season, what is the region of its home west location	2015-16_Utah_State_Aggies_men's_basketball_team
NER what is the time zone of the location in the southwest of its location	2013–14_FC_Utrecht_season
Wikimedia lists the location of the article NER which division does the location in the southwest belong to	List_of_Delta_Sigma_Theta_chapters
what is the time zone of a person or thing with the same name as NER	HSwMS_Harnosand_(K33)
NER what classification does the same name belong to?	French_destroyer_Chacal
what is the name of the administrative division of Southern NER	Llica_d'Amunt
which state does the one that is after election of NER belong to?	United_States_Senate_election_in_South_Dakota,_2014
what is the management level of NER ship name	HMCS_Parry_Sound
what is the honorary suffix of NER's ship name	HMS_Bligh_(K467)
what are the important positions of Election after NER	United_States_Senate_election_in_Vermont,_1980
where the area of the Country of NER is participating?	Irish_Civil_War
who will be people, things and things with the same name as NER next	HMS_Tarleton_(1782)
where is the title of Election after NER	United_States_Senate_election_in_West_Virginia,_2014
NER's location what is the title of the location leader in the North West?	Taltoli_Jama_Mosque
which party belongs to NER ship name	USCGC_Duane
where is the birthplace of the people, things and things with the same name as NER?	President_El_Hadj_Omar_Bongo_(ship,_1978)
what is the successor to The Descendant of NER	Berengaria_of_Castile
who is the male parent of the leader of NER?	Monarchy_of_the_North
where is the birthplace of the person or thing with the same name as NER?	Otto_Hahn_(ship)
what is the type of creator of NER	Gone_Girl_(soundtrack)
which party does NER's namesake belong to?	USS_Poinsett_(1840)
where did the commander of NER die?	Battle_of_Juyongguan
where is NER's Northwest location based?	Arrondissement_of_Amiens
what is the title of the children of NER?	Joseph_Chamberlain
where the birthplace of the city is from Captain of The NER Club	1999_FIFA_World_Youth_Championship_squads
what is the type of business of NER manager	Hisense_4K_TV_300
what is the timezong of NER's southern region?	Pancakes
who is the descendant of the parent of NER	Paul-Philippe_Hohenzollern
who is the next father of the descendants of NER?	Maria_Theresa_of_Naples_and_Sicily
who is the predecessors of L'avant de Candidate de NER	Wholesale_and_Retail_(constituency)
who is the leader of the Northwestern NER location	2013_Guangzhou_Evergrande_FC_season
who is the wife of The leader of NER	Albanian_Kingdom_(1928–39)
who is the leader of the Northeast NER location	2014_Guangzhou_Evergrande_FC_season
who is the predecessor of NER's election winner?	Colombian_presidential_election,_1998
what is the administrative district of The main town of NER	Canton_of_Aubigny-en-Artois
what is the status of the area where NER is used	Tokelauan
what is the reason for the person, thing, and thing with the same name as Bakuden Porcelain NER?	Type_Long_March_cargo_ship,_medical_evacuation
what are the awards won by NER's name ship	USS_Daniel_Inouye
where does the person and things that shares the same name with NER occur?	USS_Philippine_Sea_(CG-58)
what classification level do people, things and things with the same name as NER belong to?	HMNZS_Moa_(T233)
who leads the parliament of seats held by NER?	Scottish_Conservative_Party
what are the important positions held by NER ship name	Warren_Hastings_(1802_EIC_ship)
who is the successor of the one that is after election of NER?	South_Korean_presidential_election,_1980
what is the type of the people, things and things with the same name as NER?	RV_Neil_Armstrong_(AGOR-27)
which club does the captain of the successor of NER belong to currently?	Valerie_Adams
where did the origin of NER's name study?	Boltzmann_(crater)
what Happened in the Time of NER's Ship's Name	SMS_Novara_(1850)
which type of subdivision does the west of the north of NER belong to?	Utah,_Utah
who is NER's father's spouse	Gwangjong_of_Goryeo
what is the subdivision rank of the people, things and things with the same name as NER?	USS_Skimmer_(AMCU-41)
what is the rank of the person and things that shares the same name with NER?	SS_Rochambeau
which stadium hosts the NER Divisions	2009-10_in_Australian_soccer
what is the classification level of a person or thing with the same name as NER	HMS_Jaseur_(1807)
where the birthplace of NER's Coach is?	Hafez_Hashim
who are the generals involved in the Events in NER	Empire_of_China_(1915–16)
which field does the person and things that shares the same name with NER work in?	Akademik_Lomonosov
where did NER play work?	Steven_Poon
which state does the alma mater of NER activist, belong to?	Joanne_Grant
which rank does the people, things and things with the same name as NER belong to?	French_destroyer_Albatros
what is northwest of NER County	Burgess_Hill
what is the affiliation that the alma mater of NER belongs to?	Joanne_Grant
what's wrong with The Father of NER	Prince_Hisahito_of_Akishino
what is the name of the administrative district of Le sud de NER	Prat_de_Comte
where was the last NER-related match of the UEFA Euro 2000 held?	UEFA_Euro_2000_Final
which region does the event of NER belong to?	Archduchy_of_Austria
who is the successor of NER's election winner?	United_States_presidential_election_in_Minnesota,_1968
which place is called as the subdivision of the caption of the stadium that NER takes place?	Wales_women's_national_rugby_union_team
who is the founder of the sponsor of NER?	2011_Penrith_Panthers_season
NER, this is a song sung by Carlos Santana, it is what instrument the creator used	They_All_Went_to_Mexico
what is the management level of North East of NER World Day Venue	1991_NBA_Playoffs
which is the capital of the person and things that shares the same name with NER?	HMS_Montserrat_(K586)
what is the job title of NER's birth country leader?	Gabriel_Sacuiani
which house does the person and things that shares the same name with NER belong to?	SMS_Kaiser_Friedrich_III
NER, a Chinese politician (1913-2010) who is the current incumbent of the nominee for his title	Huang_Hua
who gave birth to the person and things that shares the same name with NER?	HMS_Osiris_(N67)
what is the famous work of the person named NER?	Shoemaker_(lunar_crater)
who is the operator of NER's famous work?	Chesley_Sullenberger
who is the heir of Election after NER	Bulgarian_Constitutional_Assembly_election,_1946
where is the title of The leader of NER	Albanian_Kingdom_(1928–39)
who is the predecessor of the previous generation where NER was held?	2012_Chinese_FA_Cup
which bay makes the eponym of NER famous?	Mach_(crater)
who is NER's eponymous wife	Cori_(lunar_crater)
who is the Prime Minister of Election after NER	Iranian_legislative_election,_1956
which division does the administrative center of the birthplace of NER belong to?	River_Inny_(Leinster)
who is the leader of the Life of NER region	Rocky_Mountains
where is the alma mater of Name of the leader of The label of NER	Hong_Kong_legislative_election,_2016_(New_Territories_West)
who do the job after the one that is after election of NER (a presidential election in finland)?	Finnish_presidential_election,_1994
what is the person whose name is used to name NER known for?	Kamerlingh_Onnes_(crater)
what is the level of people, things and things with the same name as NER?	French_ironclad_Courbet
NER consul and governor, where did his predecessor of the previous generation die	Titus_Pomponius_Proculus_Vitrasius_Pollio
NER, Bismarck-class battleship, what is the award for its namesake	German_battleship_Tirpitz
which region does the event involved in NER belong to?	Archduchy_of_Austria
what language do singers who perform for NER use	Tokyo_Juliet_(TV_series)
what are the subdivision ratings of the NER ship name	HMS_Mongoose_(1799)
NER, the American college basketball season, whose home legislature is led	2016-17_Valparaiso_Crusaders_men's_basketball_team
what war did the person or thing with the same name as NER participate in?	USNS_Lewis_B_Puller_(T-ESB-3)
what the NER Timeline team is	The_Way_It's_Goin'_Down
where is the location in the southeast of NER and in which region is the location in the southwest?	Levan,_UT
NER's location Northwest location leader's name is	1996_Guangzhou_Apollo_FC_season
where is the city of Alma mater from NER	AJ_Petrucci
The title of Explanation of NER who are the current holders	Taiwanese_municipal_elections,_2010
what is the zoning of the location in the south of the city where the Wikimedia list article NER is located	National_Register_of_Historic_Places_listings_in_Utah_County,_Utah
who is the incumbent of the title of the candidate of NER?	Constitution_election_results_in_the_United_Kingdom_general_election,_1922
which type of subdivision does the north of the location of NER belong to?	United_States_at_the_2015_World_Speed_Skating_Championships
where is the artist who sings for NER from?	Languages_of_Papua_New_Guinea
which party does the one that is after election of NER belong to?	Hungarian_presidential_election,_2000
which team does the captain of the NER club location play for?	2015_UEFA_European_Under-17_Championship_squads
who the current holders of the NER Candidate title are	Constitution_election_results_in_the_United_Kingdom_general_election,_1929
what is the provincial capital of the location in the southwest of the birthplace of NER?	River_Inny_(Leinster)
who will be Election after NER next	United_States_Senate_election_in_Ohio,_1898
what is the deathpalce of the person and things that shares the same name with NER?	Spanish_cruiser_Don_Antonio_de_Ulloa
what type of NER Timeline	The_Milt_Jackson_Big_4
what is the time zone of NER ship name	French_ship_Polyphemus_(1815)
what products do NER's sponsors have	Hisense_4K_TV_300
what are the descendants of NER's namesake?	King_George_(1785_ship)
where the birthplace of NER's coach is?	Han_Cong
what is the timezong of the body of the title of NER	George_Wallace_Jr.
what is the zoning of the location in the north of NER's home field during the American college basketball season?	2014-15_UC_Davis_Aggies_men's_basketball_team
where is the birthplace of people, things and things with the same name as NER?	SS_Charles_Bulfinch
who is the leader of the Province where the NER is located	Dhua_Kund
what time zone uses South of NER location a theme park in bandar sunway, subang jaya, selangor, malaysia?	Sunway_Lagoon
NER's candidate alias who's successor	Gedling_(UK_Parliament_constituency)
what time zone uses NER ship name	HSwMS_Harnosand_(K33)
who is the successor of the client of NER?	Royal_Palace_of_Ficuzza
what religion do NER's parents belong to?	Ronald_Lauder
who is the most important team owner of the Finnish racing driver NER?	Heikki_Kovalainen
what is the level of management at Southern NER's location	2003_in_American_soccer
what is the area covered by the Division of NER Mexico, named after Saint Joseph?	Toluca_Cathedral
what is the house of The descendant of NER	Prince_Franz_Wilhelm_of_Prussia
who is NER's father (mother)?	Francis_Russell,_Marquess_of_Tavistock
where is the place where the person, thing, and thing with the same name as the schooner and the Spanish training ship NER died?	Spanish_ship_Juan_Sebastian_Elcano
what is the club in which the head coach of the NERworks	Seattle_Sounders_FC_2
who is the predecessor of the one that is after election of NER?	Danish_general_election,_2007
which league does the operator of NER's venue play for?	Czech_Republic_national_football_team_results
what is the occupation of the founder of NER's team?	Giancarlo_Fisichella
NER, Wikimedia listing article, where is the birth city of the captain of his club location	UEFA_Euro_2012_squads
which series the NER Related Things belongs to	sony_xperia_z3+
what is the management level of NER ship name un barku den india?	INS_Mahé
what is the office of the one who is alongside NER	Steven_Poon
which province is the location province of NER settled in?	Tevshiin_Govi_coal_mine
what is the division of the southern city of NER?	Carmen,_Barcelona
what is the location of the west of the location of NER?	2000-01_Ipswich_Town_FC_season
which division does a person, thing, or thing with the same name as NER belong to?	SMS_Zenta
which dynasty does the legislature of the nationality of NER belong to?	Vanek_(surname)
what time zone is used for the location in the south of the city where the Wikimedia list article NER is located	National_Register_of_Historic_Places_listings_in_Sanpete_County,_Utah
NER, WWE's 2012 Night of Champions pay-per-view, who is its sponsor starring	Night_of_Champions_(2012)
what era of NER's ship's name is?	HMS_Malaya
what is the national team of the captain of the NER club location?	2014_FIFA_World_Cup_squads
which type of subdivision does the northwest of NER spain, belong to?	The_Palm_of_Cervello
what is the occupation of the origin of NER's name?	Mendes_Pinto_(crater)
what the party of the NER leader is	indonesian_militant_democratic_party
which division does the person or thing with the same name as NER belong to?	HMCS_Esquimalt_(J272)
which place is called as the subdivision of the northwest of NER?	Tremp
where is the city of The operator of The stadium where the NER took place	2009–10_Olympiacos_FC_season
which region does the division that NER belongs to belong to?	Toluca_Cathedral
which office does the one that is after election of NER belong to?	South_African_general_election,_1966
what is the subdivision rank of the person and things that shares the same name with NER?	Belgian_minehunter_Primula_(M924)
what language uses Lyrics from NER's title	The_Beat_Goes_On_(Super_Junior_D&E_album)
what is the award for the election winner of Minnesota's Election NER?	United_States_presidential_election_in_Minnesota,_1968
in which league The operator of The stadium where the NER took place will play?	2014–15_Olympiacos_FC_season
who are the generals participating in the The name of the NER ship	French_brig_Lodi_(1797)
which house does the people, things and things with the same name as NER belong to?	RMS_Queen_Mary_2
what is the job of the successor of the writer of NER?	My_Love:_Essential_Collection
where is the birthplace of the commander of NER?	Boundary_River_Battle_(Anti-Japanese_War)
what time zone uses NER's Eastern Site, Intercollegiate Basketball Season?	2016-17_Washington_State_Cougars_women's_basketball_team
what is the religion of the country of birth of NER	Gabriel_Sacuiani
what does a lyricist with the title of NER do?	The_Beat_Goes_On_(Super_Junior_D&E_album)
who commanded the people, things and things with the same name as NER?	USS_Chancellorsville
which place is called as the subdivision of the northwest of NER?	Gurb
what the job of NER's name is	List_of_awards_and_nominations_received_by_Billy_Ray_Cyrus
who takes the place of the descendant of the father of NER?	Ngee_Ann_Princess
what the battle of NER's ship's name is	German_destroyer_molders
what does a lyricist with the title of NER do?	Ride_Me_(album)
what the battle of NER's ship's name is	HMS_Bigbury_Bay_(K606)
who are the founders of The National Team location of NER	Jay-Jay_Okocha
which rank does the people, things and things with the same name as NER belong to?	HMS_Woodpecker_(U08)
what type of settlement is in the NER ship name	HMCS_Edmundston
what is the timezong of NER's southern region?	Vilallonga_de_Ter
what is spoken by the lyrics of the title of NER?	The_Beat_Goes_On_(Super_Junior_D&E_album)
where does the people, things and things with the same name as NER occur?	SMS_Novara_(1850)
who Will Be Your Next NER Question Club Next	Bonne_of_Bohemia
what is the club that the captain of the club that NER belongs to belongs to?	2015_UEFA_European_Under-19_Championship_squads
who is the leader of the Northwest of The stadium where the NER took place	2008-09_Chelsea_FC_season
what is the subdivision type of the south of the home to NER	2014-15_Portland_State_Vikings_women's_basketball_team
what is the religion of NER's election winner?	Central_Tibetan_Administration_general_election,_2016
what does NER related things have to do with	HTC_Desire_626
which club does NER's head coach belong to?	2014–15_SC_Freiburg_season
what are the subdivision ratings of the NER ship name	French_brig_Amarante_(1793)
what is the occupation of NER Timeline	Themes_from_Calmi_Cuori_Appassionati
which house does the legislature of the user of NER belong to?	2K22_Tunguska
where does the religion of The founder of The house of NER come from?	Norodom_Kanviman_Norleak_Tevi
what is establishedEvent in NER country	International_Association_of_Inventions'_Unions
who is the leader of the legislature of the residence of NER?	One_Life_to_Live_characters_(1968–79)
what is the name of the administrative division of The North West of NER Millionaires	National_Register_of_Historic_Places_listings_in_King_County,_Washington
what is the name of the predecessor of the club that NER belongs to?	Football_at_the_2014_Asian_Games_-_Squads
what the Legislature is in NER's Home Country	Rhones_Garvay
who is the owner of the successor of the stadium that NER takes place?	2003-04_UEFA_Champions_League_group_stage
what is the club where Captain of NER club works?	Japan_national_football_team
which city does the alma mater of NER belong to?	Bob_Padilla
who is the predecessor of Election after NER	California_gubernatorial_election,_1857
what is the management level at the South West of NER World Day Venue	Wilmington_riot_of_1968
where is the title of Election after NER	United_States_Senate_election_in_Georgia,_2014
who is the emperor of the country that uses NER	Baekje_language
where the alma mater of NER's ship name is	Otto_Hahn_(ship)
which league does the operator of NER's venue play for?	2016–17_Veria_FC_season
who led NER's events	Germania_Superior
what is the rank of the person and things that shares the same name with NER	USS_Hopper
what is the subdivision rank of the people, things and things with the same name as NER?	French_destroyer_Tigre
what are the awards for people or things with the same name as the Arleigh Burke-class destroyer, the battleship NER of this class	USS_Arleigh_Burke
which party belongs to Election after NER	Connecticut_gubernatorial_election,_2006
NER, Wikimedia listing article, what is the region of the location northwest of the city where it belongs	National_Register_of_Historic_Places_listings_in_Salt_Lake_County,_Utah
who are the generals participating in the The name of the NER ship	Nile_(1798_ship)
what is the profession of Captain of the club of NER	France_national_under-21_football_team
which religion does the commander of NER belong to?	Second_Rif_Damascus_Offensive
what is the subdivision rank of the people, things and things with the same name as NER (a barku) den estadonan uni di merka?	USS_Turkey_(AMS-56)
what is the name of the administrative district of Northeast of World NER Day Venue	Seattle_Arctic_drilling_protests
what is the subject of the one that is influenced by NER	Phaedro
who is the descendant of NER?	Ferdinand_Philippe,_Duke_of_Orleans
what is the religion of NER's election winner?	Colombian_presidential_election,_1998
which religion does the country that uses NER follow?	Baekje_language
who is the commander of the people, things and things with the same name as NER?	French_ship_Rivoli_(1810)
NER what is the positioning of its coach	2014–15_SC_Freiburg_season
what is the zoning of the place in the northwest of NER, a municipality in Spain	La_Morera_de_Montsant
what is NER Coach University	Chinese_national_women's_volleyball_team
who did a job before the one that is after election of NER?	Manila_local_elections,_2016
what is the predecessor of the operator of the position of the NER of the American college football team?	2014_BYU_Cougars_football_team
what is the religion of NER's candidate graduate school?	England_and_Wales_police_and_crime_commissioner_elections,_2012
In a French state (as of March 2015) which district is the main town of NER	Canton_of_Ailly-le-Haut-Clocher
who is the leader of the East of The stadium where the NER took place	2011_Chinese_FA_Cup
what is the canton of the north of the location of NER?	2014–15_Toulouse_FC_season
who is the successor of NER's namesake?	Spanish_cruiser_Emperador_Carlos_V
what's wrong with The Father of NER	Princess_Pingyang_(Han_dynasty)
NER its location, what are the titles of location leaders in the Northwest	2011–12_Liverpool_FC_season
what is the language of the lyricist of the title of NER	The_Beat_Goes_On_(Super_Junior_D&E_album)
where did the commander of NER die?	Boundary_River_Battle_(Anti-Japanese_War)
what eponymous domain of NER belongs to	Stokes_(Martian_crater)
who is the operator of the bay that NER is famous for?	Chesley_Sullenberger
who is the president of Inaugural speech of The title of NER	Betty_Ford
what is the type of artist who sings NER songs	I'm_so_sorry
which network does the author of NER belong to?	It's_a_SpongeBob_Christmas!_albums
who will be the next Election after NER	French_legislative_election,_1893
what is the location country of the image caption of the town of NER	List_of_blue_plaques_erected_by_the_Royal_Society_of_Chemistry
what is the title of the person and things that shares the same name with NER?	HMS_Black_Prince_(81)
what League NER Timeline Will Play In	The_Way_It's_Goin'_Down
which timezone does the east of the parent of NER belong to?	Pogorze_Bukowskie
what is the subdivision type of the northeast of the death place of NER?	Willis_H_Downs
where the alma mater of NER's ship name is	USRC_McLane_(1832)
who is the predecessor of the commander of NER?	Battle_of_Juyongguan
whose ancestor is the father of NER?	Gwangjong_of_Goryeo
the area covered by the Events in NER	Tanukhids
what is the name of the administrative district of Southern NER	Bescano
which award is the one that is after election of NER given?	United_States_presidential_election_in_Minnesota,_1968
what is the name of the predecessor of the club that NER belongs to?	Football_at_the_1990_Asian_Games_-_Squads
who is the successor of the commander of NER	Battle_of_Long_Point
what are the subdivision ratings of the NER ship name	USCGC_Mallow_(WLB-396)
which timezone does the northwest of the home to NER belong to?	2014-15_Northern_Colorado_Bears_women's_basketball_team
which religion does NER's name belong to?	Spanish_frigate_Reina_Sofia
where is the location of the Northwest Location of NER	2014–15_Bengaluru_FC_season
what is the area of the northwest location of NER Spain	The_Palm_of_Cervello
who founded the record company that issued NER?	Destiny_(Game)
The location in the south of NER and the location in the east belong to which division	New_Harmony,_UT
what is the type of manager of NER	Coca-Cola_Topnotchers
who is the successor of the one that is after election of NER?	United_States_Senate_election_in_West_Virginia,_2014
who is the father of the person, thing, thing with the same name as NER?	SMS_Erzherzog_Ferdinand_Max_(1865)
what is the name of the administrative division of The name of the vessel of NER	HSwMS_Harnosand_(K33)
what is NER Coach University	Chinese_national_women's_volleyball_team
which stadium hosts the NER Divisions	2009-10_in_Australian_soccer
who has an important influence on the person and things that shares the same name with NER?	French_frigate_Descartes
what is the occupation of the person whose name is used to name the NER?	Tikhonravov_(crater)
what is the occupation of the singer who participated in Jolin Tsai's 2006 song NER	Dancing_Forever
what is the subdivision type of the southwest of the location of NER	2015–16_PFC_CSKA_Sofia_season
what war did the first person with the title of NER fight in?	Curtis_LeMay
who is the consort of the person and things that shares the same name with NER?	Egyptian_sloop_El_Amir_Farouq
what is the subdivision type of the people, things and things with the same name as NER?	HMCS_Kamloops
what classification level do people, things and things with the same name as NER belong to?	USCGC_Salvia_(WLB-400)
what is the name of the administrative division of Northeastern Northwestern NER	Koosharem,_UT
what is the occupation of the founder of the team that NER belongs to?	Giancarlo_Fisichella
NER, the season of a football team, in which league the operator of its venue plays	2012–13_Ipswich_Town_FC_season
who is the predecessor of NER's election winner?	Italian_general_election,_1992
what time zone is in Northwest of NER	Tornabous
who is the next generation of the title of NER?	30_Rock_(season_1)
where the religion of NER's ship's name comes from	President_El_Hadj_Omar_Bongo_(ship,_1978)
what is the subdivision type of the north of the home to NER?	2012-13_Utah_State_Aggies_men's_basketball_team
which team does the captain of the NER club location play for?	2015_UEFA_European_Under-17_Championship_squads
what the profession of NER South is?	2014–15_SC_Freiburg_season
NER, Anwar, who is the successor to the 2006 election winner	Connecticut_gubernatorial_election,_2006
what is the timezong of the location province of NER	Sakhalin_coal_mine
who do the job after the one that is after election of NER?	Persian_legislative_election,_1906
which type does the location of the tenant of NER belong to?	Kunming_Tuodong_Stadium
which timezone does the city in the south of NER belong to?	Llica_d'Amunt
where is the birthplace of the city of Captain from NER's club	2010_FIFA_World_Cup_squads
which country is the image caption of the location of NER located?	Romania_national_football_team_results_(1980–99)
what is the author of NER	They_All_Went_to_Mexico
who are NER's parents' successors?	Jawaharlal_Nehru
what is the classification level of a person or thing with the same name as NER	HMS_Starling_(1829)
where was the person or thing with the same name as NER born	Otto_Hahn_(ship)
what does the successor of the descendant of NER succeed?	Princess_Louise_Caroline_of_Hesse-Kassel
NER who is the author of its themes	Planet_Snoopy
what is the genre of the sponsor of NER	Unforgiven_(2003)
who is the wife of NER's ship name	SS_Prinses_Astrid
what is the type of the person and things that shares the same name with NER?	USS_Mazama_(AE-9)
who is the successor of the spouse of the descendant of NER	Sigebert_III
what the battle of NER's ship's name is	CSS_Stonewall_Jackson
who was the Predecessor of L'avant de NER before?	Pierre_Pflimlin
what is the language that is commonly used by the combatant of NER?	Battle_of_Chiayi
which title does the leader of NER own?	Albanian_Kingdom_(1928–39)
where is the constituency of the Northern NER location	2015–16_West_Bromwich_Albion_FC_season
what is the level of management at NER's North West Site	2015-16_BYU_Cougars_women's_basketball_team
With NER what classification class does it have the same name people, things, things belong to	SMS_Seeadler_(1888)
what is the level of management at North East Stadium where NER played a football team season?	2015_Copa_do_Brasil_First_Round
NER what are the titles of location leaders in its location Northwest	2014–15_Bengaluru_FC_season
what is the zoning of the southern region of NER Spain	Gisclareny
what is the timezong of the city in the south of NER?	Polynya
what time zone is used for the administrative center of the parent of NER, a mountain range in southeastern Poland	Pogorze_Bukowskie
which league does the operator of NER's venue play for?	2015–16_AEL_Kalloni_FC_season
who is the successor of the people, things and things with the same name as NER?	RMS_Queen_Mary_2
what is the level of management in Northwest of NER	The_Soleras
To which series does the L'avant Predecessor of NER	Samsung_Galaxy_S5_Active
Jolin Tsai's 2006 song NER song, what is the occupation of the singer	Dancing_Forever
who is the successor of the people, things and things with the same name as NER?	King_George_(1785_ship)
where do NER candidates' predecessors take office?	Results_of_the_Australian_federal_election,_2016_(New_South_Wales)
what the battle of NER's ship's name is	USS_Hannibal_(AG-1)
who is the predecessor of the one that is after election of NER?/ who is the father of the one that is after election of NER?	Estonian_election_election,_2003
where is the mayor of NER	Canton_of_Bertincourt
which field does the eponym of NER work in?	Michelangelo_(crater)
where is the city of Tenants of The stadium where the NER took place	2001_Sagan_Tosu_season
who rules the father of NER?	Princess_Hongnong
where are the events included in the NER held?	2009-10_in_Australian_soccer
what is the government type of the southwest of the stadium that NER takes place?	Uzbekistan_national_under-20_football_team_results
what branch NER's ship name belongs to?	HMS_General_Wolfe_(1915)
what is the management level to the southwest of NER's place of death	James_H_Wilson
what is the timezong of the northeast of the stadium that NER takes place?	1986_Seattle_Seahawks_season
NER's location what area is the northern location in?	Business_routes_of_Interstate_15
which club does the captain of the NER club location now belong to?	UEFA_Euro_2012_squads
which place does the important event of NER take place?	2010–11_Queens_Park_Rangers_FC_season
in which league The operator of The stadium where the NER took place will play	2012–13_Luton_Town_FC_season
where does the one that is after election of NER belong to?	French_legislative_election,_1914
which national team does the captain of the club that NER belongs to belong to?	2005_FIFA_World_Youth_Championship_squads
what is the subdivision name of the southeast of the stadium that NER takes place?	2014–15_FC_Petrolul_Ploiesti_season
which program is before the author of NER?	It's_a_SpongeBob_Christmas!_albums
what does the captain of the successor of NER work for?	Valerie_Adams
who is the leader of NER's successor?	Cambodian_general_election,_2018
where is the person who was used to name the lake ner on titan	Jingpo_Lacus
what Musical Instrument NER Timeline Did He Use	Acoustic_Hearts_of_Winter
where is the heir of The descendant of NER	Grand_Duke_Vladimir_Kirillovich_of_Russia
who is the successor of the successor of NER?	Berengaria_of_Castile
which draft team does the writer of the title of NER belong to?	List_of_Star_Trek:_Deep_Space_Nine_episodes
what came before The Children of the NER	Joseph_Chamberlain
what is the name of the administrative division of Capital of The birthplace of NER	Reuss_(river)
what is the subdivision name of the northeast of the home to NER?	2015-16_Colorado_State_Rams_women's_basketball_team
NER to which time zone does the southern region belong	Masdenverge
who is the source of the NER vessel name information?	HMCS_Guelph
what time zone uses Northwest of NER	El_Molar,_Priory
what is the subdivisionRanks of The name of the vessel of NER	HMS_Sparrow_(1828)
what is the name of the administrative division of the southwest of Northwest NER utah, united states?	Fairview,_UT
what is the name of the administrative district of Area covered by the Parent of NER	Pogorze_Bukowskie
what is the title of the predecessor of the descendant of NER?	Sigebert_III
what is a related product (work) related to NER	Overhand_knot
what the Legislature is in The Land of NER	Bled_Castle
where the arrondissement of La ville principal de NER is located?	Canton_of_Tremblay-en-France
who is the successor of the namesake of the Hamburg escort NER?	Leopoldus_Primus
what is the event of the cause of NER	First_Battle_of_Newtonia
who is the predecessor of Election after NER	French_legislative_election,_1893
who is the leader of NER's ship name	Type_626_tanker
who are the current holders of the title of Explanation of NER	Taiwanese_municipal_elections,_2010
which rank does the person and things that shares the same name with NER belong to?	French_brig_Cygne_(1806)
what are the offspring of NER's parents	Neleus
what is the name of the alma mater of the leader of NER?	United_Kingdom_general_election,_1886_(Ireland)
what is the timezong of the northeast of the city that NER lives in?	National_Register_of_Historic_Places_listings_in_Horry_County,_South_Carolina
what event determined the establishment of the venue for the NER national team	Lin_Xiaocheng
what lies in the south of the event that starts the location of NER	Sun_One_Solar_Power_Station
NER's election winner who's successor	French_legislative_election,_1914
what is the classification level of people, things and things with the same name as NER?	USS_Croaker
what is the occupation of the creator of NER	Stormy_Weather_(Lena_Horne_album)
what is the region of the same name of NER?	HMCS_Kamloops
where does the title of NER belong to which time zone	George_Wallace_Jr.
which league does the team that won NER belong to?	1986_Paraguayan_Primera_Division_season
NER, Wikimedia listing article, what team is the captain of its club location	2015_FIFA_U-17_World_Cup_squads
in which area is the southern location of the NER held?	Football_at_the_2016_Pekan_Olahraga_Nasional
what Musical Instrument NER Timeline Did He Use	Stormy_Weather_(Lena_Horne_album)
where is the lyrics of the title of NER educated?	Ride_Me_(album)
who is the heir to Election after NER	New_Zealand_Labor_Party_leadership_election,_1988
which battle does the person and things that shares the same name with NER take part in?	SS_Abner_Doubleday
what is the title of the father of NER?	Princess_of_Wu_County
A city and county seat in Millard County, Utah, United States a location in the north, and what time zone is used for a location in the north	Fillmore,_UT
who is the predecessor of the person, thing, thing with the same name as NER?	Spanish_frigate_Admiral_Juan_de_Borbón
who is earlier than the one that is after election of NER?	Manila_local_elections,_2016
who managed the operator of the stadium that NER takes place?	2014_CAF_Champions_League_qualifying_rounds
what is the name of the administrative division of The North of NER Millionaires	National_Register_of_Historic_Places_listings_in_Weld_County,_Colorado
where is the northwest of the location of NER located?	San_Gabriel_Valley_Council
what type of subject is NER	The_Wizarding_World_of_Harry_Potter_(Universal_Studios_Japan)
what is the management level to the southwest of NER's place of death	Thomas_Mardaga
what is the type of person whose name is in the Wikimedia listing article NER	List_of_awards_and_nominations_received_by_Bunga_Citra_Lestari
where is the title of Election after NER	Rangitikei_by-election,_1880
what is the succession of the successor of NER?	Ferdinand_Philippe,_Duke_of_Orleans
which religion do the leaders of NER believe in?	Albanian_Kingdom_(1928–39)
who is the successor of NER's election winner?	United_States_Senate_election_in_Vermont,_1980
what is the subdivision type of the person and things that shares the same name with NER?	HMCS_New_Westminster
what is the fame of the person whose name was used to name NER?	Maclaurin_(crater)
which label does the event of NER work for?	UEFA_Women's_Euro_2013_Final
what is the subdivisionRanks of The name of the vessel of NER	HMNZS_Moa_(T233)
what is the subdivision name of the southwest of the home to NER?	2014–15_Utah_Utes_men's_basketball_team
where is the title of Inaugural speech of The title of NER	Margaret_Beckett
what is the management level of Northwest of NER	Montornes_del_Valles
what is the title of the location leader in the south of the location of NER?	2002_Lamar_Hunt_US_Open_Cup
where is the state of the NER election winner	Hawaii's_1st_congressional_district_special_election,_2010
which country does the one that is after election of NER belong to?	United_States_presidential_election_in_Wisconsin,_1880
what is the subdivisionRanks of The name of the vessel of NER	HMCS_Cormorant_(PCS_781)
who are the teams participating in the important competitions that NER participates in in a season of the football team?	2010–11_Queens_Park_Rangers_FC_season
what language uses Lyrics from The Title of NER	Hero_(Super_Junior_album)
where is the mayor of NER	Canton_of_Domart-en-Ponthieu
what is the level of management at the Northeast of NER Site	2014-15_Northern_Colorado_Bears_women's_basketball_team
where did the person or thing with the same name as NER die?	RV_Neil_Armstrong_(AGOR-27)
what offspring did the mother of the consort of King NER of Egypt have?	Ptolemy_X_Alexander_I
who is the manufacturer of things related to NER?	Kinder_Joy
what are the affiliations of NER's alma mater	Wayne_Chabre
which province is the southeast of the stadium that NER takes place settled in?	1952–53_European_Rugby_League_Championship
what is the college of the coach of NER?	Chinese_national_women's_volleyball_team
which title does the cause of NER belong to?	Zhou_Attack_on_Quwo
which league does the operator of the stadium that NER takes place belong to?	2015–16_Olympiacos_FC_season
what is the subdivision type of the west of the south of NER utah, united states?	Spanish_Fork,_Utah
what does the person and things that shares the same name with NER end up in?	HNoMS_Otra_(1939)
which timezone does the southwest of the locale of NER belong to?	Billings_Metropolitan_Transit
what is the instrument that the author of NER plays?	Hoagy_Sings_Carmichael
who are the descendants of Le chef de NER	Anhalt-Dessau-Koethen
who the descendants of NER's ship's name are?	Queen_Charlotte_(1812_ship)
what is establishedEvent in NER country	International_Association_of_Inventions'_Unions
which language is used in the author of NER?	Tyranny_(Julian_Casablancas+The_Voidz_album)
what the job of NER's name is	List_of_awards_and_nominations_received_by_Bridgit_Mendler
who is the predecessor of the leader of the label of NER?	Hong_Kong_local_elections,_2015
where is the birthplace of the person and things that shares the same name with NER?	French_cruiser_Foch
what is the timezong of the south of the southeast of NER?	Morgan,_U.T
where is the birthplace of Election after NER	Peruvian_general_election,_1985
which timezone does the city in the south of NER belong to?	Sant_Fost_de_Campsentelles
what is the zoning of the location in the west of where NER died?	Michael_William_Hyle
who are the leaders of NER	Michael_Ellis_(British_politician)
what is the position of the person and things that shares the same name with NER?	French_destroyer_Tonkinois
who does the person and things that shares the same name with NER work for?	SMS_Moltke
where was the birthplace of the person whose name was used to name the NER	Lippershey_(crater)
what is the subdivision type of the location of the location of NER?	2013-14_Lleida_Sports_season
what is the title of the one that is after election of NER?	Italian_presidential_election,_1978
who is the predecessor of the inaugural of the title of NER?/ who is the father of the inaugural of the title of NER?	Tony_Blair
With which countries the people, things and things with the same name in NER participated in the war	Waterloo_(1815_ship)
what is the stadium that hosted the Division of NER	2009-10_in_Australian_soccer
what is the country of the singer of the language NER song of a geographic region?	Languages_of_Papua_New_Guinea
what is the common language of the client of NER italy?	Doge's_Palace,_Genoa
where did NER's eponymous religion come from?	Aryabhata_(crater)
what is the party of the inaugural of the title of NER	Tony_Blair
which type does the largest city of NER belong to?	Seaman_and_Herb
which office does the leader of NER belong to?	French_National_Convention_election,_1792
which type of subdivision does the northeast of the home to NER belong to?	2015–16_Iona_Gaels_men's_basketball_team
where is the location in the east of the NER and which region is the location in the northwest?	Altamont,_UT
where is the title of Successor to Regent of NER queen of the Seleucid Empire?	Cleopatra_Thea
who is the mother of the person and things that shares the same name with NER?	RMS_Queen_Mary_2
what musical instrument did NER's name use?	List_of_awards_and_nominations_received_by_Jessica_Simpson
what is the title of NER's election winner	United_States_Senate_election_in_Kansas,_2014
what team is the captain of the NER club location	2006_FIFA_World_Cup_squads
what party is the NER's election winner?	Italian_presidential_election,_1978
where is the place where the person whose name was used to name the NER died	Galvani_(crater)
what is the job of The name of the ship of NER	Croatian_training_ship_Andrija_Mohorovičić
what is the constituency of the one that is after election of NER?	Hong_Kong_Island_by-election,_2000
The location of the football team for a season NER is in which time zone does the northern city belong?	2011-12_Valencia_CF_season
what is the name of the administrative district of the southwest of NER location	Sakura-Con
what time zone uses Area covered by the NER location	2013–14_Diósgyőri_VTK_season
What's the deal with NER's sponsors?	Coca-Cola_Topnotchers
what is the canton of the chief town of NER	Canton_of_Coucy-le-Château-Auffrique
who is the successor of the people, things and things with the same name as NER?	MV_Prins_Harald
what classification level does the person or thing with the same name as NER belong to?	Belgian_minehunter_Narcis_(M923)
who is the successor of the person or thing related to the result of the battle NER?	Battle_of_Bedriacum
what language did the previous generation of NER's lyricists speak in?	Prudence_Liew_(album)
where is the constituency of the Western Start of NER	List_of_night_buses_in_London
in which city is the operator of the venue of NER?	1999-2000_FA_Cup
who is the predecessor of Election after NER	Israeli_legislative_election,_1992
who is the president of Election after NER	United_States_Senate_election_in_Colorado,_2004
what is the famous eponymous work of NER	Levi-Civita_(crater)
in which area is the northwest location of NER Catalonia, Spain	arbucies
NER, Wikimedia listing article, what is the national team the captain of its club location belongs to	2009_FIFA_U-17_World_Cup_squads
Wikimedia lists the location of the article NER what region does the location in the east belong to?	List_of_Phi_Beta_Sigma_chapters
what is the name of the administrative district of the southwest of NER location	List_of_Sigma_Pi_chapters
what is the zoning of the location in the southeast of NER's home field?	2016-17_Oregon_State_Beavers_men's_basketball_team
what is the specialty of Election after NER?	German_presidential_election,_1994
which timezone does the person and things that shares the same name with NER belong to?	HMCS_Amherst
what is spoken by the lyrics of the title of NER?	The_Beat_Goes_On_(Super_Junior_D&E_album)
what is the subdivision name of the southwest of the northwest of NER?	Scofield,_UT
which province does the alma mater of NER belong to?	Frank_Darling_(architect)
what the management level of The North of NER's place of death is	Paul_W_Airey
who leads the legislature of the northeast of NER india?	Darjeeling_district
where is the city of The operator of The stadium where the NER took place	2014–15_Tottenham_Hotspur_FC_season
where is the constituency of Next to NER	Felix_Chung
what is the area of the location south of NER?	font-rubi
what is the religion of the people, things, things that have the same name as NER, a French destroyer	French_destroyer_Tonkinois
where is the heir of Generals of the participating NERs	Battle_of_Legnano
where is the province of the NER Client	Ludvika_Town_Hall
where did NER's eponymous religion come from?	Stokes_(Martian_crater)
who owns the operator of the stadium that NER takes place?	Nigeria_national_football_team_2012
which manager leads the tenants of NER's venue	2014–15_Charlton_Athletic_FC_season
NER's election winner who's successor	United_Malaysia_National_Organization_leadership_election,_1972
who is the predecessor of NER-related stuff	Nokia_103
who is the Prime Minister of Election after NER	United_Malaysia_National_Organization_leadership_election,_2009
what is the type of creator of NER	They_All_Went_to_Mexico
what is the successor of the writer of NER?	On_ne_change_pas
what is the war in which people, things, and things with the same name as NER participated?	Russian_destroyer_Marshal_Shaposhnikov
what is the predecessor of NER's election winner?	Italian_general_election,_1874
what classification level does the same name of NER belong to?	French_destroyer_Tigre
what does the captain of the club that NER belongs to work for?	2015_FIFA_U-17_World_Cup_squads
what is the college of the coach of NER?	Chinese_national_women's_volleyball_team
what is the famous work of the person named NER?	Marconi_(crater)
NER, the American college basketball season, which division is the southern part of its home field?	2016-17_Southern_Utah_Thunderbirds_men's_basketball_team
who is the head of the The main organ of the heads of NER	Party_leaders_of_the_United_States_Senate
what is the level of management at the southwest of The place of death of NER	Edmond_John_Fitzmaurice
which type of subdivision does the southwest of the source location of NER belong to?	River_Inny_(Leinster)
who is earlier than the predecessor of the place that NER takes place?	2016_CBA_Playoffs
who is the head of the The main body of the heads of NER	Party_leaders_of_the_United_States_Senate
where is the origin of NER's name from?	Siddons_Patera
what is the organization run by Election after NER	Hungarian_presidential_election,_2000
where is NER's eponymous Alma Mater	Haldane_(lunar_crater)
what is the specialty of Election after NER	United_Malaysia_National_Organization_leadership_election,_1972
who is the heir of L'avant Predecessor of NER	Charles_the_Fat
what is the nationality of Explanation of The Dynasty of NER	Ladislaus_of_Naples
who managed the operator of the stadium that NER takes place?	Mauritius_national_football_team_results_(2010–19)
who is earlier than the leader of NER	Michael_Ellis_(British_politician)
which musical instrument NER timeline used	Identity_(Zee_album)
who is the mother of the previous generation of the descendants of NER?	Wilhelmina_of_Prussia,_Princess_of_Orange
who is the descendant of the father of NER?	Princess_Pingyang_(Han_dynasty)
what is the people, things and things with the same name as NER?	Pizarro_(brigantine)
where is the birthplace of NER's ship name	RV_Neil_Armstrong_(AGOR-27)
who is the leader of the Northeast of The stadium where the NER took place	2013_AFC_Champions_League_group_stage
what time zone uses the southwest of The stadium where the NER took place	SV_Transvaal
what is the name of the leader of the eastern location of a sports game NER?	2016_AFC_Champions_League_group_stage
what is the timezong of the city in the south of NER	Sant_Esteve_de_la_Sarga
where did the origin of NER's name die?	Erlanger_(crater)
what is NER's title of the same name	Spanish_cruiser_Don_Antonio_de_Ulloa
what is the branch of Election after NER	United_States_Senate_election_in_Nebraska,_2002
what is the level of management at Northwest of NER	Vilada
NER, Wikimedia listing article, what is the positioning of the captain of its club location	2015_FIFA_U-17_World_Cup_squads
who will be people, things and things with the same name as NER next	Cornwallis_(1787_ship)
what is the level of management at East of NER's location	2013-14_King's_Cup
NER, Wikimedia listing article, which team the captain of their club location plays for	2010_FIFA_World_Cup_squads
what is the profession of the singer who performed for omarion's album NER	Ollusion
which type of subdivision does the people, things and things with the same name as NER belong to?	USCGC_Grand_Isle_(WPB-1338)
what is the type of NER Related Things manufactured and sold by apple computer, inc.?	IMac_G3
NER's location what time zone does the location in the northeast belong to?	Sakura-Con
what is the name of the administrative district of Le sud de NER	Prat_de_Comte
who manufactured NER's related products?	Nokia_Lumia_625
which place is called as the subdivision of the south of the city that NER lives in?	CBR_(AM)
what is the author of NER?	Horror_of_Glam_Rock
what is the job of The name of the ship of NER	French_cruiser_Lavoisier
which district does the west of the location of NER belong to?	2014–15_Evian_Thonon_Gaillard_FC_season
who is the heir of Election after NER	Danish_general_election,_2007
which type of subdivision does the northwest of NER belong to?	Mollet_de_Peralada
what zip code is the same name for NER?	HMCS_Sherbrooke
who are the current holders of the Head of Publication Event of NER	Brunei
what is the occupation of the creator of NER	Unbreakable_(Janet_Jackson_album)
what is the title of the leader of NER	Mongolian_legislative_election,_2016
what is the name of the Northwest administrative division of NER	Calafell
what is the name of the administrative district of Le nord-est de Le Stade where the NER	2010-11_NFL_playoffs
The names of leaders of people, things and things with the same name as NER are	Russian_submarine_Severodvinsk_(K-329)
who is the predecessor of Inaugural speech of The title of NER	Brian_Cowen
who is the leader of the event that occurs in NER	Germania_Superior
what club Captain of NER's Club worked at?	2015_UEFA_European_Under-17_Championship_squads
which battle does the people, things and things with the same name as NER take part in?	HMCS_Carleton
that before the person or thing related to the consequences caused by NER is?	Battle_of_Huoyi
where is the provincial capital of the same name of NER?	USS_Rawlins_(APA-226)
where is the region of The name of the ship from NER	USS_Platte_(AO-186)
what area does the administrative center of the birthplace of NER belong to?	River_Inny_(Leinster)
where is the operator of the venue of NER?	2014–15_Panathinaikos_FC_season
where is the constituency of The head of NER	Tasmanian_state_election,_1986
where is the city of Alma mater from NER	Art_Peck
what is the subdivision rank of the person and things that shares the same name with NER?	USS_Torchwood_(AN-55)
where is the city of The operator of The stadium where the NER took place	2016-17_PAOK_FC_season
what is the club that the captain of the club that NER belongs to belongs to?	2015_UEFA_European_Under-19_Championship_squads
what clubs did NER's coaches join?	Chinese_national_women's_volleyball_team
which subject does the one that is influenced by NER belong to?	Phaedro
what type of NER Timeline	Nuits_de_la_Fondation_Maeght_(Sun_Ra_album)
1998 single, what's the draft team of the creators of NER featuring Shaquille O'Neal, dj Quick, Lord Tariq and Peter Gunz	The_Way_It's_Goin'_Down
what is related to NER's ship name	USS_Somali_(DE-111)
who is the predecessors of Election after NER	United_States_Senate_election_in_Ohio,_1898
who is the predecessors of NER's ship name	PS_Lugard_II
what is the address of the operator of the venue where NER is held?	Czech_Republic_national_football_team_results
what is the title of The Father of NER	Empress_Dowager_Yingzhao
Part of what is the person, thing, thing with the same name as NER	SMS_Novara_(1850)
who are the current holders of the Nominator of The title of NER	Zhou_Enlai
what is the card description of the NER's ship name	French_ship_Polyphemus_(1815)
who is the female parent of the client of NER?	Royal_Spring,_Warsaw
NER what are the products of its sponsors	2011_Penrith_Panthers_season
what takes the place of the people, things and things with the same name as NER	Spanish_cruiser_Emperador_Carlos_V
who is the predecessor of The leader of NER	Cambodian_general_election,_2018
where is the title of Election after NER	French_legislative_election,_1914
what is the description of the map of NER's ship name	USS_Cimarron_(AO-177)
what is the origin of NER's namesake	HMCS_Ville_de_Quebec_(K242)
who founded the record company NER belongs to?	Destiny_(Game)
what is the religion of NER's spouse's spouse	Tyti
what is the legislature for the position of NER's national team?	Dalio_Danzano_domain
NER, Wikimedia listing article, what team is the captain of its club location	2006_FIFA_World_Cup_squads
what is the northwest where the national team of the ukrainian football player NER is hosted	Demetrius_Kigelensky
which royal house does the person and things that shares the same name with NER belong to?	Princess_Selandia
what is the religion of the country that is spoken NER	Baekje_language
NER, Wikimedia listing article, what is the positioning of the captain of its club location	UEFA_Euro_2012_squads
where are the heirs of The winner of NER	Battle_of_Tanshebrai
what is the league in which the operator of The stadium where the NER took place will play	2008–09_Everton_FC_season
what is the name of the Northwest administrative division of NER	El_Montmell
where is the city of The operator of The stadium where the NER took place	2011-12_FA_Cup
NER's election winner who's successor	First_Māori_elections
who the responsible actor for NER is?	Night_of_Champions_(2012)
what does the namesake of NER have to do with	Chilean_brigantine_Araucano
which timezone does the northwest of NER belong to?	Batea,_Tarragona
who is the predecessor of the one that is after election of NER?	United_States_Senate_election_in_New_York,_1964
what is the canton of the chief town of NER	Canton_of_Villers-Cotterets
who are the affiliates of Alma mater de NER	Amy_Jephta
who is NER's father's successor?	Yelu_Aburi
what is the administrative district of the person, thing, and thing with the same name as NER?	Vaygach_(1989_icebreaker)
NER what is the division of its home field?	2016-17_Kansas_Jayhawks_women's_basketball_team
which field does the person whose name is used to name NER work in?	Hevelius_(crater)
what is the time zone of Northwest of NER	Vilanova_de_Segria
what is the job of the predecessor of the lyrics of NER?	Prudence_Liew_(album)
who is the successor of NER's general	The_Battle_of_Dingtao_(Eastern_Han_Dynasty)
what time zone is the location south of NER in?	The_Vall_d'en_Bass
who are the children of the Election after NER	United_States_presidential_election_in_Minnesota,_1968
what club Captain of NER's Club worked at?	2010_FIFA_World_Cup_squads
who is the successor of the previous generation of the successor of NER?	Philip_Haddon-Cave
what the NER main town area is?	Canton_of_Saint-Nicolas-de-la-Grave
which institution is NER's alma mater affiliated to?	Patricia_Clavin
who is the prime minister of the leader of NER	Michael_Ellis_(British_politician)
what time zone uses NER South	pine_trees
which place is called as the subdivision of the east of the parent of NER	Pogorze_Bukowskie
what is the type of the person and things that shares the same name with NER?	USCGC_Pontchartrain_(1928)
what country was the captain of the NER club location born in?	1999_FIFA_World_Youth_Championship_squads
what is the management level of The North of The South of NER utah, united states?	Logan,_UT
where is the operator of the stadium that NER takes place located?	1967–68_EU_Lleida_season
NER, Wikimedia list article, what is the region of the location east of the city where it belongs	National_Register_of_Historic_Places_listings_in_Wasatch_County,_Utah
who is the king of NER's election winner	British_general_election,_1727
which dynasty did the descendants of NER belong to?	Pyinbya
who is issued by the person and things that shares the same name with NER?	Princess_Selandia
what is the logo of NER's label	I'm_Xiao_Xiao
who is the President of Election after NER	Israeli_legislative_election,_1992
who is the leader of the Northern Place of NER	2008_Davis_Cup_Americas_Zone_Group_I
who do the job after the one that is after election of NER	First_Māori_elections
what is the specialty of Election after NER	Cameroonian_election_election,_2002
which title does the inaugural of the title of NER own?	Paulo_Muwanga
which dynasty is the one that is after election of NER born?	Town_of_New_Plymouth_by-election,_1865
what time zone uses Northwest of NER	La_Vall_de_Bianya
which place is called as the subdivision of the east of the parent of NER?	Pogorze_Bukowskie
who is the leader of the Northwest of The stadium where the NER took place	Uzbekistan_national_under-23_football_team_results
what titles do NER's candidate successors hold?	Constitution_election_results_in_the_United_Kingdom_general_election,_1923
what is the name of the administrative division of West of NER's place of death	Henry_Brewerton
what area is the NER's home east?	2015-16_South_Dakota_State_Jackrabbits_men's_basketball_team
what is the previous generation of the operator of NER's successor	Hard_Rock_Stadium
who is the heir of Election after NER	Town_of_New_Plymouth_by-election,_1865
which type of subdivision does the northwest of NER belong to?	The_Senia
A city in Emory County, Utah, United States, located in the southwest of NER, the location in the west, which time zone the location belongs to	Emery,_UT
Whose name is NER's predecessor?	Spanish_cruiser_Don_Antonio_de_Ulloa
which countries are the sources of the names of the cities that participate in the NER of the Wikimedia list article	National_Register_of_Historic_Places_listings_in_Tennessee
what is the club that the captain of the club that NER belongs to belongs to?	2006_FIFA_World_Cup_squads
where is the city of The operator of The stadium where the NER took place	2014–15_AEL_Kalloni_FC_season
and NER who has been influenced by the person or thing with the same name	French_frigate_Descartes
who is the predecessor of the cause of NER?	Battle_of_Bedriacum
what is the subdivision type of the northeast of the southeast of NER utah, united states?	Meadow,_U.T
what is the famous work of NER's eponymous	Stokes_(Martian_crater)
which product belongs to the sponsor of NER	Louis_Schwitzer_Award
who is the next the cause of NER	Battle_of_Huoyi
where is the administrative center of Northern NER's location	State_highways_serving_Virginia_state_institutions
what is the subdivision name of the city in the south of NER spain?	Lliça_de_Vall
what is the title of the person and things that shares the same name with NER	French_cruiser_Georges_Leygues
where the religion of Election after NER came from	Danish_general_election,_2007
what is the subdivision name of the northeast of the death place of NER?	Michael_Angelo_Saltarelli
which series does the sponsor of the 2003 World Wrestling Entertainment pay-to-view event NER belong to?	Unforgiven_(2003)
which general leads NER-related events	Empire_of_China_(1915–16)
what classification level does the same name of NER belong to?	USS_Turkey_(AMS-56)
what is the profession of Your next club Editor of NER	The_Collector's_Series,_Volume_One
where was NER's father's birthplace	Gyeongjong_of_Goryeo
which region does the event of NER belong to?	Tanukhids
what is the language that is commonly used by the cause of NER?	Kalmar_War
what time zone uses Northern NER Site	2014-15_Santa_Clara_Broncos_women's_basketball_team
what is the zoning of the location in the northeast of NER?	2008_Vancouver_Whitecaps_FC_season
NER what is the zoning of the location in the west of its location	2017_Lamar_Hunt_US_Open_Cup_qualifying
where does the source of the NER name belong?	Volta_(crater)
where NER's The Name of the Ship takes place?	French_ship_Rivoli_(1810)
who is earlier than the one that is after election of NER?	French_legislative_election,_1914
where NER's The Name of the Ship takes place?	Italian_cruiser_Varese
what is the author of NER?	Stormy_Weather_(Lena_Horne_album)
where is the people, things and things with the same name as NER born?	MS_Giulio_Cesare
which party does the one that is after election of NER belong to?	Israeli_legislative_election,_1981
who is the predecessor of Election after NER	National_Justice_Party_leadership_election,_2001
who is the successor of the successor of the place where NER is held?	2010_FIFA_World_Cup_qualifying_–_AFC_Third_Round
which party does the legislature in the birthplace of NER belong to?	Reuss_(river)
which title does the one that is after election of NER own?	French_legislative_election,_1893
what is the origin of NER's name?	Baco_(crater)
